Short Frame	_ws.short
Malformed Packet	_ws.malformed
Unreassembled Fragmented Packet	_ws.unreassembled
Type Length Mismatch	_ws.type_length
Byte Array-String Decoding Error	_ws.byte_array_string.decoding_error
Date and Time-String Decoding Error	_ws.date_time_string.decoding_error
String Errors	_ws.string
Wireshark Field/Fundamental Types	_ws.ftypes
Wireshark Columns	_ws.col
IEEE 1722 Audio Video Transport Protocol (AVTP)	ieee1722
IEEE 1722.1 Protocol	ieee17221
IEC 61883 Protocol	iec61883
AVTP Audio Format	aaf
ACF Message	acf
ACF CAN	acf-can
ACF LIN	acf-lin
Clock Reference Format	crf
AVTP Compressed Video Format	cvf
Non-Time-Synchronous Control Format	ntscf
Time-Synchronous Control Format	tscf
Pro-MPEG Code of Practice #3 release 2 FEC Protocol	2dparityfec
3Com XNS Encapsulation	3comxns
IPv6 over Low power Wireless Personal Area Networks	6lowpan
Plan 9	9p
AllJoyn Name Service Protocol	ajns
AllJoyn Message Protocol	aj
AllJoyn Reliable Datagram Protocol	ardp
FiveCo's Legacy Register Access Protocol	5co_legacy
FiveCo RAP Register Access Protocol	5co_rap
HI2Operations	HI2operations
ISystemActivator ISystemActivator Resolver	isystemactivator
S101	s101
3GPP2 A11	a11
A21 Protocol	a21
Arinc 615a Protocol	a615a
Find Identification of Network Devices	find
Appletalk Address Resolution Protocol	aarp
Aastra Signalling Protocol	aasp
Ericsson A-bis OML	gsm_abis_om2000
GSM A-bis OML	gsm_abis_oml
GSM A-bis P-GSL	gsm_abis_pgsl
GSM A-bis TFP	gsm_abis_tfp
Application Configuration Access Protocol	acap
AUDIOCODES DEBUG RECORDING	acdr
Architecture for Control Networks	acn
Magic Bullet	magic
RDMnet	rdmnet
ACP133 Attribute Syntaxes	acp133
Advanced Card Systems ACR122	acr122
ISO 8650-1 OSI Association Control Service	acse
ISO 10035-1 OSI Connectionless Association Control Service	clacse
AudioCodes Trunk Trace	actrace
Android Debug Bridge	adb
Android Debug Bridge Client-Server	adb_cs
Android Debug Bridge Service	adb_service
ADwin communication protocol	adwin
ADwin configuration protocol	adwin_config
Aeron Protocol	aeron
Apple Filing Protocol	afp
Andrew File System (AFS)	afs
AgentX	agentx
AOL Instant Messenger	aim
AIM Administrative	aim_admin
AIM Advertisements	aim_adverts
AIM Privacy Management Service	aim_bos
AIM Buddylist Service	aim_buddylist
AIM Chat Service	aim_chat
AIM Chat Navigation	aim_chatnav
AIM Directory Search	aim_dir
AIM E-mail	aim_email
AIM Generic Service	aim_generic
AIM ICQ	aim_icq
AIM Invitation Service	aim_invitation
AIM Location	aim_location
AIM Messaging	aim_messaging
AIM Popup	aim_popup
AIM Signon	aim_signon
AIM Server Side Info	aim_ssi
AIM Server Side Themes	aim_sst
AIM Statistics	aim_stats
AIM Translate	aim_translate
AIM User Lookup	aim_lookup
Advanced Intelligent Network	ain
Apache JServ Protocol v1.3	ajp13
Asynchronous Layered Coding	alc
AAL type 2 signalling protocol (Q.2630)	alcap
ATSC Link-Layer Protocol	alp
Action Message Format	amf
AMP	amp
Advanced Message Queuing Protocol	amqp
AMQP Version 0.9	amqp.version.v0_9
AMQP Version 0.10	amqp.version.v0_10
AMQP Version 1.0	amqp.version.v1_0
Adaptive Multi-Rate	amr
Adaptive Multi-Rate WB	amr_wb
Automatic Multicast Tunneling	amt
Access Node Control Protocol	ancp
Intel ANS probe	ans
ANSI IS-637-A (SMS) Teleservice Layer	ansi_637_tele
ANSI IS-637-A (SMS) Transport Layer	ansi_637_trans
ANSI IS-683 (OTA (Mobile))	ansi_683
ANSI IS-801 (Location Services (PLD))	ansi_801
ANSI A-I/F BSMAP	ansi_a_bsmap
ANSI A-I/F DTAP	ansi_a_dtap
ANSI Mobile Application Part	ansi_map
ANSI Transaction Capabilities Application Part	ansi_tcap
Ad hoc On-demand Distance Vector Routing Protocol	aodv
ATAoverEthernet	aoe
America Online	aol
SINEC AP Telegram	sinecap
Apple IP-over-IEEE 1394	ap1394
Apple Network-MIDI Session Protocol	applemidi
Automatic Position Reporting System	aprs
aptX Codec	aptx
AR Drone Packet	ar_drone
ARCNET	arcnet
The Armagetron Advanced OpenGL Tron clone	armagetronad
Address Resolution Protocol	arp
ATM Address Resolution Protocol	atmarp
Artemis Core Protocol	artemis
Art-Net	artnet
Aruba Discovery Protocol	adp
Aruba Networks encapsulated remote mirroring	aruba_erm
Aruba Networks encapsulated remote mirroring - PCAP (Type 0)	aruba_erm_type0
Aruba Networks encapsulated remote mirroring - PEEK (Type 1)	aruba_erm_type1
Aruba Networks encapsulated remote mirroring - AIRMAGNET (Type 2)	aruba_erm_type2
Aruba Networks encapsulated remote mirroring - PCAP+RADIO (Type 3)	aruba_erm_type3
Aruba Networks encapsulated remote mirroring - PPI (Type 4)	aruba_erm_type4
Aruba Networks encapsulated remote mirroring - PEEK (Type 5)	aruba_erm_type5
Aruba Networks encapsulated remote mirroring - RADIOTAP (Type 6)	aruba_erm_type6
Aruba Instant AP Protocol	aruba_iap
ASAM Capture Module Protocol	asam-cmp
Aggregate Server Access Protocol	asap
Lucent/Ascend debug output	ascend
Alert Standard Forum	asf
Asphodel	asphodel
ASTERIX packet	asterix
AT Command	at
Allied Telesis Loop Detection	atldf
LocalTalk Link Access Protocol	llap
Datagram Delivery Protocol	ddp
Name Binding Protocol	nbp
AppleTalk Transaction Protocol packet	atp
AppleTalk Session Protocol	asp
Printer Access Protocol	prap
Zone Information Protocol	zip
Routing Table Maintenance Protocol	rtmp
Apache Tribes Heartbeat Protocol	ath
Asynchronous Transfer Mode	atm
ATM AAL1	aal1
ATM AAL3/4	aal3_4
ATM OAM AAL	oamaal
ILMI	ilmi
ATM LAN Emulation	lane
ATM over TCP	atmtcp
ICAO Doc9705 CM	atn-cm
ICAO Doc9705 CPDLC	atn-cpdlc
ICAO Doc9705 ULCS	atn-ulcs
Cisco Auto-RP	auto_rp
AUTOSAR I-PDU Multiplexer	ipdum
AUTOSAR Network Management	autosar-nm
Arista Vendor Specific Protocol	avsp
Apple Wireless Direct Link data frame	awdl_data
Apple Wireless Direct Link action frame	awdl
Amateur Radio AX.25	ax25
AX.25 KISS	ax25_kiss
AX.25 no Layer 3	ax25_nol3
DX cluster	dx
AX/4000 Test Block	ax4000
Anything in Anything Protocol	ayiya
Babel Routing Protocol	babel
Building Automation and Control Network APDU	bacapp
Building Automation and Control Network NPDU	bacnet
PPP Bandwidth Allocation Control Protocol	bacp
Favored-Peer	bacp.opt.favored_peer
Twisted Banana	banana
PPP Bandwidth Allocation Protocol	bap
Link Type	bap.opt.link_type
Phone Delta	bap.opt.phone_delta
No Phone Number Needed	bap.opt.no_phone
Reason	bap.opt.reason
Link Discriminator	bap.opt.link_disc
Call Status	bap.opt.call_status
Logical-Link Control Basic Format XID	basicxid
B.A.T.M.A.N. Layer 3 Protocol	bat
B.A.T.M.A.N. GW	bat.gw
B.A.T.M.A.N. Vis	bat.vis
B.A.T.M.A.N. Advanced Protocol	batadv
Black Box Log	bblog
PPP Bridging Control Protocol Bridged PDU	bcp_bpdu
PPP Bridging Control Protocol Network Control Protocol	bcp_ncp
Bridge-Identification	bcp_ncp.opt.bridge_id
Line-Identification	bcp_ncp.opt.line_id
MAC-Support	bcp_ncp.opt.mac_sup
Tinygram-Compression	bcp_ncp.opt.tinygram_comp
LAN-Identification (obsoleted)	bcp_ncp.opt.lan_id
MAC-Address	bcp_ncp.opt.mac_addr
Spanning-Tree-Protocol (old formatted)	bcp_ncp.opt.stp
IEEE 802 Tagged Frame	bcp_ncp.opt.ieee_802_tagged_frame
Management Inline	bcp_ncp.opt.management_inline
Bridge Control Packet Indicator	bcp_ncp.opt.bcp_ind
BCTP Q.1990	bctp
Blocks Extensible Exchange Protocol	beep
Bencode	bencode
Basic Encoding Rules (ASN.1 X.690)	ber
Binary Floor Control Protocol	bfcp
Bidirectional Forwarding Detection Control Message	bfd
Bidirectional Forwarding Detection Echo Packet	bfd_echo
Border Gateway Protocol	bgp
Bearer Independent Call Control	bicc
3GPP BICC MST	bicc_mst
Bitcoin protocol	bitcoin
BitTorrent	bittorrent
Canon BJNP	bjnp
BLIP Couchbase Mobile	blip
bluecom Protocol	bluecom
Bluetooth	bluetooth
Broadcast/Multicast Control	bmc
BGP Monitoring Protocol	bmp
Wellfleet Breath of Life	bofl
Boot Parameters	bootparams
Spanning Tree Protocol	stp
Amateur Radio BPQ	bpq
DTN Bundle Protocol Security	bpsec
Bundle Protocol	bundle
DTN Bundle Protocol Version 7	bpv7
BPv7 Block Type	bpv7.block_type
BPv7 Administrative Record	bpv7.admin_rec
BPv7 Administrative Record Type	bpv7.admin_record_type
Broadcom tag protocol	brcm-tag
Boardwalk	brdwlk
BRP Protocol	brp
BSSAP	bssap
BSSAP2	bssap_plus
BSAP	bsap
BSSAP-LE	bssap_le
Base Station Subsystem GPRS Protocol	bssgp
Bluetooth 3DS Profile	bt3ds
BitTorrent DHT Protocol	bt-dht
BitTorrent Tracker	bt-tracker
uTorrent Transport Protocol	bt-utp
Bluetooth A2DP Profile	bta2dp
Bluetooth A2DP Content Protection Header SCMS-T	bta2dp_content_protection_header_scms_t
AltBeacon	alt_beacon
Apple iBeacon	ibeacon
Google/Apple Exposure Notification	bluetooth.gaen
Bluetooth AMP Packet	btamp
Bluetooth Attribute Protocol	btatt
Bluetooth AVCTP Protocol	btavctp
Bluetooth AVDTP Protocol	btavdtp
Bluetooth AVRCP Profile	btavrcp
Bluetooth BNEP Protocol	btbnep
Bluetooth Pseudoheader for BR/EDR	btbredr_rf
Bluetooth BR/EDR FHS	btbredr_fhs
Bluetooth Common	btcommon
Bluetooth DUN Packet	btdun
Bluetooth GATT Attribute Protocol	btgatt
Bluetooth GNSS Profile	btgnss
Bluetooth HCI ACL Packet	bthci_acl
Bluetooth HCI Command	bthci_cmd
Bluetooth HCI Event	bthci_evt
Bluetooth HCI ISO Packet	bthci_iso
Bluetooth HCI SCO Packet	bthci_sco
Bluetooth Broadcom HCI	bthci_vendor.broadcom
Bluetooth Intel HCI	bthci_vendor.intel
Bluetooth HCRP Profile	bthcrp
Bluetooth HFP Profile	bthfp
Bluetooth HID Profile	bthid
Bluetooth HSP Profile	bthsp
Bluetooth L2CAP Protocol	btl2cap
Bluetooth Low Energy Link Layer	btle
Bluetooth Low Energy RF Info	btle_rf
Bluetooth Link Manager Protocol	btlmp
Bluetooth MCAP Protocol	btmcap
Bluetooth Mesh	btmesh
Bluetooth Mesh Beacon	beacon
Bluetooth Mesh PB-ADV	pbadv
Bluetooth Mesh Provisioning PDU	provisioning
Bluetooth Mesh Proxy	btmproxy
BTP-A	btpa
BTP-B	btpb
Bluetooth RFCOMM Protocol	btrfcomm
Bluetooth SAP Profile	btsap
Bluetooth SDP Protocol	btsdp
Bluetooth Security Manager Protocol	btsmp
Symbian OS BTSNOOP File Format	btsnoop
Bluetooth SPP Packet	btspp
Bluetooth VDP Profile	btvdp
Bluetooth VDP Content Protection Header SCMS-T	btvdp_content_protection_header_scms_t
DCE/DFS BUDB	budb
DCE/RPC BUTC	butc
BACnet Virtual Link Control	bvlc
BACnet Secure Connect Virtual Link Control	bscvlc
Bazaar Smart Protocol	bzr
ANSI C12.22	c1222
C15 Call History Common Header Protocol	c15.ch
C15 Call History Protocol	c15
C15 Tone	c15.tone
C15 Incoming GWE	c15.inc_gwe
C15 Outgoing GWE	c15.out_gwe
C15 Call History Heartbeat Protocol	c15hbeat
Calculation Application Protocol	calcappprotocol
Camel	camel
Controller Area Network over Ethernet	caneth
CANopen	canopen
Control And Provisioning of Wireless Access Points - Control	capwap
Control And Provisioning of Wireless Access Points - Data	capwap.data
Card Application Toolkit ETSI TS 102.223	etsi_cat
Common Address Redundancy Protocol	carp
Cast Client Control Protocol	cast
Catapult DCT2000 packet	dct2000
ETSI Card Application Toolkit Transport Protocol	cattp
PPP Callback Control Protocol	cbcp
No callback	cbcp.opt.no_callback
Callback to a user-specified number	cbcp.opt.callback_user
Callback to a pre-specified or admin-specified number	cbcp.opt.callback_admin
Callback to any of a list of numbers	cbcp.opt.callback_list
Concise Binary Object Representation	cbor
Citizen Broadband Radio Service - Object Identifiers	cbrs_oids
GSM Cell Broadcast Service	gsm_cbs
3GPP/GSM Cell Broadcast Service Protocol	cbsp
Concurrent Connection Packet	cipcc
USB CCID	usbccid
PPP Compression Control Protocol	ccp
OUI	ccp.opt_oui
Predictor type 1	ccp.opt.predict1
Predictor type 2	ccp.opt.predict2
Puddle Jumper	ccp.opt.puddle
Hewlett-Packard PPC	ccp.opt.hpppc
Stac Electronics LZS	ccp.opt.stac
Stac Electronics LZS (Ascend Proprietary version)	ccp.opt.stac_ascend
Microsoft PPE/PPC	ccp.opt.mppe
Gandalf FZA	ccp.opt.gfza
V.42bis compression	ccp.opt.v42bis
BSD LZW Compress	ccp.opt.bsdcomp
LZS-DCP	ccp.opt.lzsdcp
MVRCA (Magnalink)	ccp.opt.mvrca
PPP for Data Compression in Data Circuit-Terminating Equipment (DCE)	ccp.opt.dce
Deflate	ccp.opt.deflate
V.44/LZJH compression	ccp.opt.v44lzjh
CCSDS	ccsds
H.324/CCSRL	ccsrl
CDMA2K	cdma2k
Cisco Discovery Protocol	cdp
PPP CDP Control Protocol	cdpcp
CDS Clerk Server Calls	cds_clerkserver
DCE/RPC CDS Solicitation	cds_solicit
Compressed Data Type	cdt
Common External Message Interface	cemi
Ceph	ceph
PKIX CERT File Format	pkix-cert
Circuit Emulation Service over Ethernet	cesoeth
CFDP	cfdp
CFM EOAM IEEE 802.1Q/ITU-T Y.1731 Protocol	cfm
Cisco Group Management Protocol	cgmp
PPP Challenge Handshake Authentication Protocol	chap
Character Generator Protocol	chargen
Charging ASE	chargingase
Cisco HDLC	chdlc
Common Image Generator Interface	cigi
Computer Interface to Message Distribution	cimd
Cimetrics MS/TP	cimetrics
Common Industrial Protocol	cip
CIP Class Generic	cipcls
CIP Connection Manager	cipcm
CIP PCCC Object	cippccc
CIP Modbus Object	cipmb
CIP Connection Configuration Object	cipcco
Common Industrial Protocol, Motion	cipm
Common Industrial Protocol, Motion - Rev 3	cipm3
Common Industrial Protocol, Safety	cipsafety
Common Industrial Protocol, Safety - Base - Data	cipsafety_bd
Common Industrial Protocol, Safety - Extended - Data	cipsafety_ed
Common Industrial Protocol, Safety - Base - Time Coordination	cipsafety_bt
Common Industrial Protocol, Safety - Extended - Time Coordination	cipsafety_et
CIP Safety Supervisor	cipssupervisor
CIP Safety Validator	cipsvalidator
CableLabs Layer 3 Protocol	cl3
CableLabs Dual-Channel Wi-Fi	cl3dcw
Simple Traversal of UDP Through NAT	classicstun
Clearcase NFS	clearcase
Classical IP frame	clip
Clique Reliable Multicast Protocol	clique-rm
ISO 8473/X.233 CLNP ConnectionLess Network Protocol	clnp
ISO 9548-1 OSI Connectionless Session Protocol	clsp
ISO 8602/X.234 CLTP ConnectionLess Transport Protocol	cltp
Cisco MetaData	cmd
X711 CMIP	cmip
Certificate Management Protocol	cmp
China Mobile Point to Point Protocol	cmpp
Cryptographic Message Syntax	cms
Component Network over IP	cnip
Constrained Application Protocol	coap
collectd network data	collectd
Community ID Flow Hashing	communityid
PPP Compressed Datagram	comp_data
Component Status Protocol	componentstatusprotocol
DCE/RPC Conversation Manager	conv
Common Open Policy Service	cops
Totemnet Layer of Corosync Cluster Engine	corosync_totemnet
Totem Single Ring Protocol implemented in Corosync Cluster Engine	corosync_totemsrp
CBOR Object Signing and Encryption	cose
COSE Parameter Subdissectors	cose_params
CoSine IPNOS L2 debug output	cosine
ISO 8073/X.224 COTP Connection-Oriented Transport Protocol	cotp
Couchbase Protocol	couchbase
CP2179 Protocol	cp2179
Cross Point Frame Injector	cpfi
Check Point High Availability Protocol	cpha
DNS Control Program Server	cprpc_server
Cassandra CQL Protocol	cql
Credential Security Support Provider	credssp
Certificate Request Message Format	crmf
CSM_ENCAPS	csm_encaps
CSN.1	csn1
Cluster TDB	ctdb
Common Unix Printing System (CUPS) Browsing Protocol	cups
CVS pserver	cvspserver
Cisco Wireless IDS Captures	cwids
Digital Audio Access Protocol	daap
X.519 Directory Access Protocol	dap
Data	data
Daytime Protocol	daytime
Dropbox LAN sync Protocol	db-lsp
Dropbox LAN sync Discovery Protocol	db-lsp-disc
D-Bus	dbus
Distributed Checksum Clearinghouse protocol	dcc
Datagram Congestion Control Protocol	dccp
DCE/RPC UpServer	dce_update
Distributed Computing Environment / Remote Procedure Call (DCE/RPC)	dcerpc
IWBEMLEVEL1LOGIN (pidl)	IWbemLevel1Login
Microsoft AT-Scheduler Service	atsvc
DCE DFS Basic Overseer Server	bossvr
RPC Browser	rpc_browser
Failover Cluster Management API (clusapi)	clusapi
DNS Server	dnsserver
Active Directory Replication	drsuapi
Active Directory Setup	dssetup
EFS (pidl)	efs
Event Logger	eventlog
Microsoft File Replication Service API	frsapi
File Replication Service	frsrpc
File Replication Service DFS-R	frstrans
File Server Remote VSS Protocol	fsrvp
Init shutdown service	initshutdown
IRemoteWinspool SubSystem	iremotewinspool
Local Security Authority	lsarpc
MAPI	mapi
Spotlight metadata search service	mdssvc
Microsoft Messenger Service	messenger
MISC (pidl)	misc
Settings for Microsoft Distributed File System	netdfs
Microsoft Network Logon	rpc_netlogon
Exchange 5.5 Name Service Provider	nspi
Microsoft Plug and Play service	pnp
Exchange 2003 Directory Request For Response	rfr
Microsoft Routing and Remote Access Service	rras
RS Interface properties	rs_plcy
SAMR (pidl)	samr
Microsoft Spool Subsystem	spoolss
Server Service	srvsvc
Service Control	svcctl
Microsoft Telephony API Service	tapi
Microsoft Task Scheduler Service	taskschedulerservice
Microsoft Distributed Link Tracking Server Service	trksvr
Remote Registry Service	winreg
SMB Witness Service	witness
Workstation Service	wkssvc
Wireless Configuration Service	wzcsvc
DICOM	dicom
DCOM	dcom
DCOM IDispatch	dispatch
DCOM IProvideClassInfo	provideclassinfo
DCOM ITypeInfo	typeinfo
ETSI Distribution & Communication Protocol (for DRM)	dcp-etsi
DCP Application Framing Layer	dcp-af
DCP Protection, Fragmentation & Transport Layer	dcp-pft
DCP Tag Packet Layer	dcp-tpl
Dynamic DNS Tools Protocol	ddtp
DEC Spanning Tree Protocol	dec_stp
DEC DNA Routing Protocol	dec_dna
DECT Protocol	dect
DECT DLC (LAPC)	dect_dlc
Aastra/Mitel DECT-over-Ethernet	dect_mitel_eth
Mitel RFP/OMM TCP communication protocol	dect_mitel_rfp
DECT NWK	dect_nwk
DeviceNet Protocol	devicenet
Dynamic Host Configuration Protocol	dhcp
DHCP Failover	dhcpfo
DHCPv6	dhcpv6
DHCPv6 Bulk Leasequery	dhcpv6.bulk_leasequery
DHCPv6 Cablelabs	dhcpv6_cablelabs
Diameter Protocol	diameter
Diameter 3GPP	diameter.3gpp
Distributed Interactive Simulation	dis
Discard Protocol	discard
X.519 Directory Information Shadowing Protocol	disp
Distcc Distributed Compiler	distcc
DJI UAV Drone Control Protocol	djiuav
Dynamic Link Exchange Protocol	dlep
DLEP Data Item Dissector	dlep.dataitem
Distributed Lock Manager	dlm3
Data Link SWitching	dlsw
Diagnostic Log and Trace (DLT)	dlt
Shortened Diagnostic Log and Trace (DLT) Storage Header	dlt.storage
Direct Message Profile	dmp
DMX	dmx
DMX Channels	dmx_chan
DMX SIP	dmx_sip
DMX Test Frame	dmx_test
DMX Text Frame	dmx_text
Distributed Network Protocol 3.0	dnp3
Domain Name System	dns
Multicast Domain Name System	mdns
Link-local Multicast Name Resolution	llmnr
Microsoft Delivery Optimization	msdo
Digital Object Identifier Resolution Protocol	do-irp
DOCSIS	docsis
DOCSIS MAC Management	docsis_mgmt
DOCSIS Synchronisation Message	docsis_sync
DOCSIS Upstream Channel Descriptor	docsis_ucd
DOCSIS Upstream Bandwidth Allocation - version 1	docsis_map
DOCSIS Upstream Bandwidth Allocation - version 5	docsis_map
DOCSIS Range Request Message	docsis_rngreq
DOCSIS Ranging Response	docsis_rngrsp
DOCSIS Registration Requests	docsis_regreq
DOCSIS Registration Responses	docsis_regrsp
DOCSIS Upstream Channel Change Request	docsis_uccreq
DOCSIS Upstream Channel Change Response	docsis_uccrsp
DOCSIS Baseline Privacy Key Management Request	docsis_bpkm.req
DOCSIS Baseline Privacy Key Management Response	docsis_bpkm.rsp
DOCSIS Registration Acknowledge	docsis_regack
DOCSIS Dynamic Service Addition Request	docsis_dsareq
DOCSIS Dynamic Service Addition Response	docsis_dsarsp
DOCSIS Dynamic Service Addition Acknowledge	docsis_dsaack
DOCSIS Dynamic Service Change Request	docsis_dscreq
DOCSIS Dynamic Service Change Response	docsis_dscrsp
DOCSIS Dynamic Service Change Acknowledge	docsis_dscack
DOCSIS Dynamic Service Delete Request	docsis_dsdreq
DOCSIS Dynamic Service Delete Response	docsis_dsdrsp
DOCSIS Downstream Channel Change Request	docsis_dccreq
DOCSIS Downstream Channel Change Response	docsis_dccrsp
DOCSIS Downstream Channel Change Acknowledge	docsis_dccack
DOCSIS Upstream Channel Descriptor Type 29	docsis_type29ucd
DOCSIS Initial Ranging Message	docsis_intrngreq
DOCSIS Downstream Channel Descriptor	docsis_dcd
DOCSIS MAC Domain Description	docsis_mdd
DOCSIS Bonded Initial Ranging Message	docsis_bintrngreq
DOCSIS Upstream Channel Descriptor Type 35	docsis_type35ucd
DOCSIS Dynamic Bonding Change Request	docsis_dbcreq
DOCSIS Dynamic Bonding Change Response	docsis_dbcrsp
DOCSIS Dynamic Bonding Change Acknowledge	docsis_dbcack
DOCSIS Path Verify Request	docsis_dpv.req
DOCSIS Path Verify Response	docsis_dpv.rsp
DOCSIS CM-STATUS Report	docsis_cmstatus
DOCSIS Status Report Acknowledge	docsis_cmstatusack
DOCSIS CM Control Request	docsis_cmctrl.req
DOCSIS CM Control Response	docsis_cmctrlrsp
DOCSIS Registration Request Multipart	docsis_regreqmp
DOCSIS Registration Response Multipart	docsis_regrspmp
DOCSIS Energy Management Request	docsis_emreq
DOCSIS Energy Management Response	docsis_emrsp
DOCSIS OFDM Channel Descriptor	docsis_ocd
DOCSIS Downstream Profile Descriptor	docsis_dpd
DOCSIS Upstream Channel Descriptor Type 51	docsis_type51ucd
OFDM Downstream Profile Test Request	docsis_optreq
OFDM Downstream Profile Test Response	docsis_optrsp
OFDM Downstream Profile Test Acknowledge	docsis_optack
DOCSIS Resource Block Assignment Message	docsis_rba
DOCSIS Extended Range Request Message	docsis_ext_rngreq
DOCSIS Appendix C TLVs	docsis_tlv
DOCSIS Vendor Specific Encodings	docsis_vsif
DOF Tunnel Protocol Stack	dtps
DOF Protocol Stack	dof
DOF Protocol Stack TCP	dof-tcp
DOF Protocol Stack UDP	dof-udp
DOF Object Identifier	dof.oid
DOF Network Protocol	dof.dnp
DOF Network Protocol V0	dof.dnp.v0
DOF Network Protocol V1	dof.dnp.v1
DOF Presentation Protocol	dof.dpp
DOF Presentation Protocol V0	dof.dpp.v0
DOF Presentation Protocol V2	dof.dpp.v2
DOF Presentation Protocol V2 Support	dof.dpp.v2s
DOF Application Protocol	dof.app
DOF Session Protocol	dof.esp
DOF CCM Security Mode App	dof.ccm.app
DOF CCM Security Mode of Operation	dof.ccm
DOF CCM Security Mode DSP Options	dof.ccm.dsp
DOF Object Access Protocol	dof.oap
DOF Object Access Protocol DSP Options	dof.oap.dsp
DOF Secure Group Management Protocol	dof.sgmp
DOF Ticket Exchange Protocol Version 1	dof.tep1
DOF Ticket Exchange Protocol DSP Options	dof.tep1.dsp
DOF Ticket Request Protocol	dof.trp
DOF Ticket Request Protocol DSP Options	dof.trp.dsp
DoIP (ISO13400) Protocol	doip
X.501 Directory Operational Binding Management Protocol	dop
DisplayPort AUX-Channel	dpaux
DPAUXMON DisplayPort AUX channel monitor	dpauxmon
DirectPlay Protocol	dplay
DirectPlay 8 protocol	dpnet
Digital Private Signalling System No 1	dpnss
Digital Private Signalling System No 1 Link Layer	dpnss_link
Distributed Ruby	drb
DRBD Protocol	drbd
DRDA	drda
UAVCAN DSDL	uavcan_dsdl
Data Stream Interface	dsi
MPEG DSM-CC	mpeg_dsmcc
X.519 Directory System Protocol	dsp
Dynamic Source Routing	dsr
Digital Transmission Content Protection over IP	dtcp-ip
Datagram Transport Layer Security	dtls
Dynamic Trunk Protocol	dtp
DeskTop PassThrough Protocol	dtpt
DCE Distributed Time Service Provider	dtsprovider
DCE Distributed Time Service Local Server	dtsstime_req
DPNSS/DASS2-User Adaptation Layer	dua
DVB Application Information Table	dvb_ait
DVB Bouquet Association Table	dvb_bat
DVB-DATA MultiProtocol Encapsulation	dvb_data_mpe
DVB Event Information Table	dvb_eit
ETSI IPDC Bootstrap	dvb_ipdc
DVB Network Information Table	dvb_nit
DVB-S2 Mode Adaptation Header	dvb-s2_modeadapt
DVB-S2 Baseband Frame	dvb-s2_bb
DVB-S2 GSE Packet	dvb-s2_gse
DVB-S2 Signalization Table	dvb-s2_table
DVB Service Description Table	dvb_sdt
DVB Selection Information Table	dvb_sit
DVB Time and Date Table	dvb_tdt
DVB Time Offset Table	dvb_tot
DVB Common Interface	dvb-ci
Distance Vector Multicast Routing Protocol	dvmrp
Data Exchange Layer	dxl
E100 Encapsulation	e100
ITU-T E.164 number	e164
E1 Application Protocol	e1ap
ITU-T E.212 number	e212
E2 Application Protocol	e2ap
Extensible Authentication Protocol	eap
802.1X Authentication	eapol
EBHSCR Protocol	ebhscr
Echo	echo
ECMP	ecmp
Edge Control Protocol	ecp21
ECP Protocol	ecp
evolved Common Public Radio Interface	ecpri
eDonkey Protocol	edonkey
Extreme Discovery Protocol	edp
EERO Protocol	eero
Ethernet Global Data	egd
Ericsson HDLC	ehdlc
EHS	ehs
Enhanced Interior Gateway Routing Protocol	eigrp
ETV-AM EISS Section	eiss
Elasticsearch	elasticsearch
ELCOM Communication Protocol	elcom
Executable and Linkable Format	elf
Ethernet Local Management Interface	elmi
OpenBSD Encapsulating device	enc
EtherNet/IP (Industrial Protocol)	enip
Common Industrial Protocol, I/O	cipio
Common Industrial Protocol, I/O Class 1	cipio1
Device Level Ring	dlr
Endpoint Handlespace Redundancy Protocol	enrp
ENTTEC	enttec
Enhanced Order Book Interface 10.0	eobi
Ethernet POWERLINK	epl
ETHERNET Powerlink V1.0	epl_v1
DCE/RPC Endpoint Mapper	epm
DCE/RPC Endpoint Mapper v4	epm4
Erlang Port Mapper Daemon	epmd
IEEE 802.3 EPON Preamble	epon
Extensible Record Format	erf
Erlang Distribution Protocol	erldp
Encapsulated Remote Switch Packet ANalysis	erspan
CISCO ERSPAN3 Marker Packet	erspan-marker
SAIA Ether-S-I/O protocol	esio
ISO 9542 ESIS Routeing Information Exchange Protocol	esis
Extended Security Services	ess
802.1BR E-Tag	etag
Apache Etch Protocol	etch
Ethernet	eth
Ethernet over IP	etherip
Ethertype	ethertype
Enhanced Trading Interface 10.0	eti
ETV-AM DII Section	etv-dii
ETV-AM DDB Section	etv-ddb
Event Tracing for Windows	etw
Enhanced Variable Rate Codec	evrc
Enhanced Variable Rate Codec B	evrcb
Enhanced Variable Rate Codec - Wideband	evrcwb
Enhanced Variable Rate Codec - Narrowband-Wideband	evrcnw
Enhanced Variable Rate Codec - Narrowband-Wideband plus 2kpbs	evrcnw2k
Enhanced Variable Rate Codec (Legacy Encapsulation)	evrc_legacy
Enhanced Voice Services	evs
Exablaze trailer	exablaze
Remote Process Execution	exec
EXtreme extra Eth Header	exeh
EXPORTED_PDU	exported_pdu
Extreme Mesh	extrememesh
Extreme Mesh Control Header	extrememesh_mch
Extreme Mesh L2 Update	extrememesh_l2upd
Extreme Mesh Probe Message	extrememesh_probe
Extreme Mesh Path Selection Authorization Request	extrememesh_ps_areq
Extreme Mesh Path Selection Authorization Reply	extrememesh_ps_arep
Extreme Mesh Path Selection Bind Request	extrememesh_ps_breq
Extreme Mesh Path Selection Bind Reply	extrememesh_ps_brep
Extreme Mesh Path Selection Bind Announcement	extrememesh_ps_bann
Extreme Mesh Path Selection Bind Removed	extrememesh_ps_bred
Extreme Mesh Path Selection Status Request	extrememesh_ps_sreq
Extreme Mesh Path Selection Status Reply	extrememesh_ps_srep
Extreme Mesh Path Selection Path Request	extrememesh_ps_preq
Extreme Mesh Path Selection Path Reply	extrememesh_ps_prep
Extreme Mesh Path Selection Path Error	extrememesh_ps_perr
Extreme Mesh Path Selection Path Reset	extrememesh_ps_prst
Extreme Mesh Path Selection Proxy Remove	extrememesh_ps_prem
Extreme Mesh Path Selection Trace Path	extrememesh_ps_trace
Extreme Mesh Path Selection Proxy Error	extrememesh_ps_prer
F1 Application Protocol	f1ap
F5 Ethernet Trailer Protocol	f5ethtrailer
F5 Ethernet trailer provider - Noise	f5ethtrailer.provider.noise
F5 Ethernet Trailer Protocol - TLS Provider	f5ethtrailer.tls
F5 Capture Information	f5fileinfo
(Facebook) Zero Protocol	fb_zero
Fibre Channel	fc
Fibre Channel Delimiters	fcsof
Fc00 CryptoAuth	fc00
Fibre Channel Common Transport	fcct
Fibre Channel Name Server	fcdns
FC Extended Link Svc	fcels
FC Fabric Configuration Server	fcs
Fibre Channel Fabric Zone Server	fcfzs
FastCGI	fcgi
FCIP	fcip
Fibre Channel over Ethernet	fcoe
Fibre Channel over Infiniband	fcoib
Fibre Channel Protocol for SCSI	fcp
Fibre Channel Single Byte Command	fcsb3
Fibre Channel Security Protocol	fcsp
Fibre Channel SW_ILS	swils
Fiber Distributed Data Interface	fddi
Foundry Discovery Protocol	fdp
Far End Failure Detection	fefd
Sony FeliCa	felica
FOUNDATION Fieldbus	ff
File	file
BLF File Format	file-blf
BLF Ethernet Status	blf-ethernet-status
DLT File Format	file-dlt
PCAP File Format	file-pcap
DCE DFS File Exporter	fileexp
finger	finger
FCoE Initialization Protocol	fip
Financial Information eXchange Protocol	fix
DCE DFS Fileset Location Server	fldb
FlexNet	flexnet
FlexRay Protocol	flexray
NSN FLIP	flip
File Mapping Protocol	fmp
File Mapping Protocol Notify	fmp_notify
Flight Message Transfer Protocol (FMTP)	fmtp
Forwarding and Control Element Separation Protocol	forces
FortiGate Cluster Protocol - HeartBeat	fortinet_fgcp_hb
Fortinet Single Sign On	fortinet_sso
FP	fp
FP Hint	fp_hint
Huawei FP Multiplexing Header	fp_mux
IEEE 802.3br Frame Preemption Protocol	fpp
Frame Relay	fr
Fractal Generator Protocol	fractalgeneratorprotocol
Frame	frame
Packet comments	pkt_comment
System Call	syscall
ISO 8571 FTAM	ftam
FTDI FT USB	ftdi-ft
FTDI Multi-Protocol Synchronous Serial Engine	ftdi-mpsse
File Transfer Protocol (FTP)	ftp
FTP Data	ftp-data
FTServer Operations	ftserver
Checkpoint FW-1	fw1
G.723	g723
Gadu-Gadu Protocol	gadu-gadu
GBCS GBZ	gbcs_gbz
GBCS Message	gbcs_message
GBCS Tunnel	gbcs_tunnel
GCSNA	gcsna
GDB Remote Serial Protocol	gdb
Firebird SQL Database Remote Protocol	gdsdb
Generic Data Transfer Protocol	gdt
Gearman Protocol	gearman
Cisco GED-125 Protocol	ged125
Graylog Extended Log Format	gelf
Generic Network Virtualization Encapsulation	geneve
GeoNetworking	gnw
Generic Framing Procedure	gfp
Compuserve GIF	image-gif
giFT Internet File Transfer	gift
General Inter-ORB Protocol	giop
Coseventcomm Dissector Using GIOP API	giop-coseventcomm
Cosnaming Dissector Using GIOP API	giop-cosnaming
Gias Dissector Using GIOP API	giop-gias
Parlay Dissector Using GIOP API	giop-parlay
Tango Dissector Using GIOP API	giop-tango
Git Smart Protocol	git
Gateway Load Balancing Protocol	glbp
Glow	glow
GlusterFS Callback	glusterfs.cbk
Gluster CLI	gluster.cli
Gluster Dump	gluster.dump
Gluster Daemon	glusterd
Gluster Daemon Management	glusterd.mgmt
Gluster Daemon Brick Operations	glusterd.brick
Gluster Daemon Friend Operations	glusterd.friend
GlusterFS Handshake	glusterfs.hndsk
Gluster Portmap	gluster.pmap
GlusterFS	glusterfs
Gigamon Header	gmhdr
Gigamon Trailer	gmtrailer
GEO-Mobile Radio (1) BCCH	gmr1.bcch
GEO-Mobile Radio (1) Common	gmr1.common
GEO-Mobile Radio (1) DTAP	gmr1.dtap
GEO-Mobile Radio (1) RACH	gmr1.rach
GEO-Mobile Radio (1) RR	gmr1.rr
GEO-Mobile Radio (1) CCCH	gmr1.ccch
GARP Multicast Registration Protocol	gmrp
Gnutella Protocol	gnutella
GOOSE	goose
R-GOOSE	r-goose
Gopher	gopher
GPEF	gpef
GPRS CDR	gprscdr
GQUIC (Google Quick UDP Internet Connections)	gquic
Generic Routing Encapsulation	gre
Huawei GRE bonding	grebonding
GRPC Message	grpc
GSM A-I/F BSSMAP	gsm_a.bssmap
GSM A-I/F COMMON	gsm_a
3GPP COMMON	3gpp
GSM A-I/F DTAP	gsm_a.dtap
GSM A-I/F GPRS Mobility and Session Management	gsm_a.gm
GSM A-I/F RP	gsm_a.rp
GSM A-I/F Radio Resource Management	gsm_a.rr
GSM CCCH	gsm_a.ccch
GSM RACH	gsm_a.rach
GSM SACCH	gsm_a.sacch
GSM EC-CCCH	gsm_a.ec_ccch
BSS LCS Assistance Protocol	bsslap
Lb-I/F BSSMAP LE	gsm_bssmap_le
GSM Cell Broadcast Channel	gsm_cbch
GSM L2R Character Oriented Protocol (L2RCOP)	gsm_l2rcop
GSM Mobile Application	gsm_map
GSM-R User-to-User Signaling	gsm-r-uus1
Radio Link Control, Medium Access Control, 3GPP TS44.060	gsm_rlcmac
GSM SIM 11.11	gsm_sim
GSM SMS TPDU (GSM 03.40)	gsm_sms
GSM Short Message Service User Data	gsm_sms_ud
GSM Um Interface	gsm_um
GSM Radio Link Protocol (RLP)	gsm_rlp
GSM Radiotap	gsmtap
GSMTAP libosmocore logging	gsmtap_log
GSS-API Generic Security Service Application Program Interface	gss-api
Osmocom General Subscriber Update Protocol	gsup
GPRS Tunneling Protocol	gtp
GPRS Tunneling Protocol Prime	gtpprime
NRUP	nrup
GPRS Tunneling Protocol V2	gtpv2
GigE Vision Control Protocol	gvcp
GARP VLAN Registration Protocol	gvrp
GigE Vision Streaming Protocol	gvsp
Sinec H1 Protocol	h1
ITU-T Recommendation H.223	h223
ITU-T Recommendation H.223 (Bitswapped)	h223_bitswapped
H.224	h224
H323-MESSAGES	h225
H.225 RAS	h225_ras
H235-SECURITY-MESSAGES	h235
MULTIMEDIA-SYSTEM-CONTROL	h245
H.248 MEGACO	h248
H.248 3GPP	h248.3gpp
H.248.7	h248.an
H.248 Annex C	h248.annexc
H.248 Annex E	h248e
H.248.10	h248.chp
H.248.2	h248.2
ITU-T Recommendation H.261	h261
ITU-T Recommendation H.263 RTP Payload header (RFC4629)	h263p
ITU-T Recommendation H.263	h263
H.264	h264
H.265	h265
H.282 Remote Device Control	rdc
H.283 Logical Channel Transport	lct
H.323	h323
H.450 Supplementary Services	h450
H.450 Remote Operations Apdus	h450.ros
H.460 Supplementary Services	h460
H.501 Mobility	h501
HART_IP Protocol	hart_ip
Hazelcast Wire Protocol	hzlcst
Palo Alto Heartbeat Backup	hbbak
Bluetooth HCI H1	hci_h1
Bluetooth HCI H4	hci_h4
Bluetooth Linux Monitor Transport	hci_mon
Bluetooth HCI USB Transport	hci_usb
Hummingbird NFS Daemon	hclnfsd
Hotline Command-Response Transaction protocol	hcrt
High bandwidth Digital Content Protection	hdcp
High bandwidth Digital Content Protection version 2	hdcp2
HDFS Protocol	hdfs
HDFSDATA Protocol	hdfsdata
High-Definition Multimedia Interface	hdmi
Host IP Configuration Protocol	hicp
Host Identity Protocol	hip
HiPerConTracer Trace Service	hipercontracer
Harman HiQnet	hiqnet
High-Speed LAN Instrument Protocol	hislip
Health Level Seven	hl7
UTRAN Iuh interface HNBAP signalling	hnbap
HomePlug protocol	homeplug
HomePlug AV protocol	homeplug-av
HomePNA, wlan link local tunnel	hpna
HP encapsulated remote mirroring	hp_erm
HP Extended Local-Link Control	hpext
HPFEEDS HoneyPot Feeds Protocol	hpfeeds
HP Switch Protocol	hpsw
HP NIC Teaming Heartbeat	hpteam
High Speed Fahrzeugzugang	hsfz
High-speed SECS Message Service Protocol	hsms
High-availability Seamless Redundancy (IEC62439 Part 3 Chapter 5)	hsr
HSR/PRP Supervision (IEC62439 Part 3)	hsr_prp_supervision
Cisco Hot Standby Router Protocol	hsrp
Hypertext Transfer Protocol	http
Simple Service Discovery Protocol	ssdp
HyperText Transfer Protocol 2	http2
Hypertext Transfer Protocol Version 3	http3
HTML Form URL Encoded	urlencoded-form
HyperSCSI	hyperscsi
Inter-Integrated Circuit	i2c
I2C Events	i2c_event
I2C Data	i2c_data
Inter-Access-Point Protocol	iapp
Inter-Asterisk eXchange v2	iax2
Infiniband Sockets Direct Protocol	infiniband_sdp
iCall Communication Protocol	icall
Internet Content Adaptation Protocol	icap
Internet Communications Engine Protocol	icep
DCE DFS ICL RPC	icl_rpc
Internet Control Message Protocol	icmp
Internet Control Message Protocol v6	icmpv6
Internet Cache Protocol	icp
ICQ Protocol	icq
ID3v2	id3v2
X.519 Internet Directly Mapped Protocol	idmp
Ilda Digital Network Protocol	idn
Internetwork Datagram Protocol	idp
ISO/IEC 10747 (1993): Inter Domain Routing Protocol 	idrp
IEC 60870-5-101	iec60870_101
IEC 60870-5-104	iec60870_104
IEC 60870-5-103	iec60870_5_103
IEC 60870-5-101/104 ASDU	iec60870_asdu
IEEE1609dot2	ieee1609dot2
IEEE 1905.1a	ieee1905
IEEE 802.11 wireless LAN aggregate frame	wlan_aggregate
IEEE 802.11 wireless LAN	wlan
IEEE 802.11 wireless LAN (Centrino)	wlan_centrino
IEEE 802.11 wireless LAN extension frame	wlan_ext
Prism capture header	prism
802.11 radio information	wlan_radio
AVS WLAN Capture header	wlancap
IEEE 802.15.4 Low-Rate Wireless PAN	wpan
IEEE 802.15.4 Low-Rate Wireless PAN non-ASK PHY	wpan-nonask-phy
ZBOSS IEEE 802.15.4 dump	wpan-zboss
IEEE 802.15.4 Low-Rate Wireless PAN TAP	wpan-tap
IEEE 802.1ah	ieee8021ah
IEEE 802.1ad	ieee8021ad
802.1CB Redundancy Tag	ieee8021cb
IEEE802a OUI Extended Ethertype	ieee802a
iFCP	ifcp
Internet Group membership Authentication Protocol	igap
Internet Group Management Protocol	igmp
Cisco Interior Gateway Routing Protocol	igrp
OMA Internal Location Protocol	ilp
Internet Message Access Protocol	imap
Internet Message Format	imf
Intelligent Network Application Protocol	inap
InfiniBand	infiniband
InfiniBand Link	infiniband_link
Mellanox EoIB Encapsulation Header	infiniband.eoib
Interlink Protocol	interlink
Internet Protocol Version 4	ip
IP Option - End of Options List (EOL)	ip.options.eol
IP Option - No-Operation (NOP)	ip.options.nop
IP Option - Security	ip.options.security
IP Option - Loose Source Route	ip.options.route
IP Option - Time Stamp	ip.options.timestamp
IP Option - Extended Security	ip.options.ext_security
IP Option - Commercial Security	ip.options.cipso
IP Option - Record Route	ip.options.record_route
IP Option - Stream ID	ip.options.sid
IP Option - Strict Source Route	ip.options.source_route
IP Option - MTU Probe	ip.options.mtu_probe
IP Option - MTU Reply	ip.options.mtu_reply
IP Option - Traceroute	ip.options.traceroute
IP Option - Router Alert	ip.options.routeralert
IP Option - Selective Directed Broadcast	ip.options.sdb
IP Option - Quick-Start	ip.options.qs
GSM over IP protocol as used by ip.access	gsm_ipa
GSM over IP ip.access CCM sub-protocol	ipaccess
International Passenger Airline Reservation System	ipars
PPP IP Control Protocol	ipcp
IP Addresses (deprecated)	ipcp.opt.addrs
IP Compression Protocol	ipcp.opt.compress
IP Address	ipcp.opt.addr
Mobile Node's Home IP Address	ipcp.opt.mobileipv4
Primary DNS Server IP Address	ipcp.opt.pri_dns
Primary NBNS Server IP Address	ipcp.opt.pri_nbns
Secondary DNS Server IP Address	ipcp.opt.sec_dns
Secondary NBNS Server IP Address	ipcp.opt.sec_nbns
Profiles (RFC3241)	ipcp.opt.rohc.profile_bytes
RTP compression (RFC2508)	ipcp.opt.iphc.rtp_compress
Enhanced RTP compression (RFC3545)	ipcp.opt.iphc.enhanced_rtp_compress
Negotiating header compression (RFC3545)	ipcp.opt.iphc.neghdrcomp
IP Device Control (SS7 over IP)	ipdc
IPDR	ipdr
SAMIS-TYPE-1 Record	ipdr_samis_type_1
iPerf2 Packet Data	iperf2
iPerf3 Speed Test	iperf3
IP Over FC	ipfc
CRTP	crtp
CRTP (CUDP 16)	crtp_cudp16
CRTP (CUDP 8)	crtp_cudp8
CRTP (CS)	crtp_cs
CRTP (CNTCP)	crtp_cntcp
Intelligent Platform Management Interface	ipmi
Intelligent Platform Management Bus	ipmb
Keyboard Controller Style Interface	kcs
Serial Terminal Mode Interface	tmode
Intelligent Platform Management Interface (Session Wrapper)	ipmi_session
IPMI Trace Data Collection	ipmi.trace
Solaris IPNET	ipnet
IP over Infiniband	ipoib
IPOS Kernel Packet Protocol	ipos
Internet Printing Protocol	ipp
Internet Printing Protocol Over USB	ippusb
Authentication Header	ah
Encapsulating Security Payload	esp
IP Payload Compression	ipcomp
IPSICTL	ipsictl
Internet Protocol Version 6	ipv6
IPv6 Hop-by-Hop Option	ipv6.hopopts
Routing Header for IPv6	ipv6.routing
IPv6 Routing Type - Source Route	ipv6.routing.type.rt0
IPv6 Routing Type - Type 2	ipv6.routing.type.mipv6
IPv6 Routing Type - RPL Source Route	ipv6.routing.type.mipv6
IPv6 Routing Types - Segment Routing	ipv6.routing.type.srh
IPv6 Routing Types - Compact Routing	ipv6.routing.type.crh
Fragment Header for IPv6	ipv6.fraghdr
Destination Options for IPv6	ipv6.dstopts
PPP IPv6 Control Protocol	ipv6cp
Interface Identifier	ipv6cp.opt.interface_identifier
IPv6 compression	ipv6cp.opt.compress
IP Virtual Services Sync Daemon	ipvs
Internetwork Packet eXchange	ipx
Sequenced Packet eXchange	spx
IPX Routing Information Protocol	ipxrip
NetWare Serialization Protocol	nw_serial
IPX Message	ipxmsg
Service Advertisement Protocol	ipxsap
IPX WAN	ipxwan
Internet Relay Chat	irc
Client To Client Protocol	irc.ctcp
Internet Security Association and Key Management Protocol	isakmp
iSCSI	iscsi
ISDN	isdn
ISDN supplementary services	isdn_sup
iSCSI Extensions for RDMA	iser
Intelligent Service Interface	isi
ISO 10589 ISIS InTRA Domain Routeing Information Exchange Protocol	isis
ISO 10589 ISIS Complete Sequence Numbers Protocol Data Unit	isis.csnp
ISIS HELLO	isis.hello
ISO 10589 ISIS Link State Protocol Data Unit	isis.lsp
ISO 10589 ISIS Partial Sequence Numbers Protocol Data Unit	isis.psnp
Cisco ISL	isl
ISMACryp Protocol	ismacryp
ISMACryp Protocol v1.1	ismacryp_v11
ISMACryp Protocol v2.0	ismacryp_v20
InterSwitch Message Protocol	ismp
iSNS	isns
ISO10681 Protocol	iso10681
ISO/IEC 14443	iso14443
ISO15765 Protocol	iso15765
ISO/IEC 7816	iso7816
ISO/IEC 7816-3	iso7816.atr
ISO 8583-1	iso8583
Bluetooth ISO Data	bthci_iso_data
ISObus	isobus
ISObus Virtual Terminal	isobus.vt
ISDN User Part	isup
Internal TDM	itdm
Intelligent Transport Systems	its
ITS message - DENM	its.message.denm
ITS message - DENMv1	its.message.denmv1
ITS message - CAM	its.message.cam
ITS message - CAMv1	its.message.camv1
ITS message - SPATEMv1	its.message.spatemv1
ITS message - SPATEM	its.message.spatem
ITS message - MAPEMv1	its.message.mapemv1
ITS message - MAPEM	its.message.mapem
ITS message - IVIMv1	its.message.ivimv1
ITS message - IVIM	its.message.ivim
ITS message - EVRSR	its.message.evrsr
ITS message - SREM	its.message.srem
ITS message - SSEM	its.message.ssem
ITS message - RTCMEMv1	its.message.rtcmemv1
ITS message - RTCMEM	its.message.rtcmem
ITS message - EVCSN	its.message.evcsn
ITS message - TISTPG	its.message.tistpg
ITS message - CPM	its.message.cpm
ITS message - VAM	its.message.vam
ITS message - IMZM	its.message.imzm
DSRC Addition Grp C (EU)	dsrc.addgrpc
ISDN Q.921-User Adaptation Layer	iua
IuUP	iuup
iWARP Direct Data Placement and Remote Direct Memory Access Protocol	iwarp_ddp_rdmap
Ixia Trailer	ixiatrailer
ixveriwave	ixveriwave
SAE J1939	j1939
Java Debug Wire Protocol	jdwp
JPEG File Interchange Format	image-jfif
Juniper Packet Mirror	jmirror
RFC 2435 JPEG	jpeg
JavaScript Object Notation	json
JSON 3GPP	json.3gpp
Juniper	juniper
JXTA P2P	jxta
JXTA Message	jxta.message
K12xx	k12
Kerberos Administration	kadm5
Kafka	kafka
Kontiki Delivery Protocol	kdp
Kismet Drone/Server Protocol	kdsp
Kerberos	kerberos
Kingfisher	kf
Kerberized Internet Negotiation of Key	kink
Kismet Client/Server Protocol	kismet
Kernel Lock Manager	klm
kNet Protocol	knet
KNX/IP	kip
MS Kpasswd	kpasswd
KPM V2	kpm-v2
Kerberos v4	krb4
DCE/RPC Kerberos V	krb5rpc
Kyoto Tycoon Protocol	kt
Layer 1 Event Messages	data-l1-events
Layer 2 Tunneling Protocol	l2tp
LACP	lacp
LANforge Traffic Generator	lanforge
Link Access Procedure Balanced (LAPB)	lapb
Link Access Procedure Balanced Ethernet (LAPBETHER)	lapbether
Link Access Procedure, Channel D (LAPD)	lapd
Link Access Procedure, Channel Dm (LAPDm)	lapdm
Laplink	laplink
Link Access Procedure, Satellite channel (LAPSat)	lapsat
Local Area Transport	lat
29West Protocol	29west
LBMC Protocol	lbmc
LBMPDM Protocol	lbmpdm
LBMPDM over TCP Protocol	lbmpdm_tcp
LBM Topic Resolution Protocol	lbmr
LBM Stateful Resolution Service Protocol	lbmsrs
LBT Reliable Multicast Protocol	lbtrm
LBT Reliable Unicast Protocol	lbtru
LBT TCP Protocol	lbttcp
PPP Link Control Protocol	lcp
Vendor Specific	lcp.opt.vendor
Maximum Receive Unit	lcp.opt.mtu_bytes
Async Control Character Map	lcp.opt.asyncmap_bytes
Authentication Protocol	lcp.opt.auth_protocol_bytes
Quality Protocol	lcp.opt.quality_protocol_bytes
Magic Number	lcp.opt.magic_number_bytes
Link Quality Monitoring	lcp.opt.linkqualmon
Protocol Field Compression	lcp.opt.field_compress
Address and Control Field Compression	lcp.opt.addr_field_compress
FCS Alternatives	lcp.opt.fcs_alternatives_bytes
Self Describing Pad	lcp.opt.self_desc_pad
Numbered Mode	lcp.opt.numbered_mode
Callback	lcp.opt.callback
Compound Frames (Deprecated)	lcp.opt.compound_frames
Nominal Data Encapsulation (Deprecated)	lcp.opt.nomdataencap
Multilink MRRU	lcp.opt.multilink_mrru
Multilink Short Sequence Number Header	lcp.opt.multilink_ssnh
Multilink Endpoint Discriminator	lcp.opt.multilink_ep_disc
DCE Identifier	lcp.opt.dce_identifier
Multi Link Plus Procedure	lcp.opt.multilink_pp
Link Discriminator for BACP	lcp.opt.link_discrim_bytes
Authentication Option	lcp.opt.auth
Consistent Overhead Byte Stuffing (COBS)	lcp.opt.cobs
Prefix Elision	lcp.opt.prefix_elision
Multilink header format	lcp.opt.multilink_hdr_fmt
Internationalization	lcp.opt.internationalization
Simple Data Link on SONET/SDH	lcp.opt.sonet_sdh
LCS Application Protocol	lcsap
LDAC Codec	ldac
Lightweight Directory Access Protocol	ldap
Connectionless Lightweight Directory Access Protocol	cldap
Label Distribution Protocol	ldp
Local Download Sharing Service	ldss
Landis & Gyr Telegyr 8979	lg8979
LGE Monitor	lge_monitor
5G Lawful Interception	5gli
LIN Protocol	lin
Link 16	link16
ENEA LINX	linx
ENEA LINX over TCP	linxtcp
Locator/ID Separation Protocol	lisp
Locator/ID Separation Protocol (Data)	lisp-data
Locator/ID Separation Protocol (Reliable Transport)	lisp-tcp
Lithionics Battery Management System	lithionics_bms
X2 xIRI payload	xiri
DCE/RPC NCS 1.5.1 Local Location Broker	llb
Logical-Link Control	llc
Logical Link Control GPRS	llcgprs
Link Layer Discovery Protocol	lldp
Low Level Reader Protocol	llrp
ATSC3 Low Level Signalling	lls
Veritas Low Latency Transport (LLT)	llt
Link Layer Topology Discovery	lltd
Local Management Interface	lmi
Link Management Protocol (LMP)	lmp
Lustre Network	lnet
Local Number Portability Database Query	lnpdqp
Locamation Interface Module CALIBRATION	locamation-im.calibration
Locamation Interface Module IDENT	locamation-im.ident
Locamation Interface Module SAMPLES - IM1	locamation-im.samples.im1
Locamation Interface Module SAMPLES - IM2R0	locamation-im.samples.im2r0
3GPP log packet	log3gpp
Android Logcat	logcat
Android Logcat Text	logcat_text
Logotype Certificate Extensions	logotypecertextn
Local Operating Network	lon
Configuration Test Protocol (loopback)	loop
LoRaTap header	loratap
LoRaWAN Protocol	lorawan
Line Printer Daemon Protocol	lpd
LTE Positioning Protocol (LPP)	lpp
LTE Positioning Protocol A (LPPa)	lppa
LTE Positioning Protocol Extensions (LLPe)	lppe
Pegasus Lightweight Stream Control	lsc
Local Service Discovery	lsd
LTE Radio Resource Control (RRC) protocol	lte_rrc
Licklider Transmission Protocol	ltp
Lustre	lustre
LWAPP Encapsulated Packet	lwapp
LWAPP Layer 3 Packet	lwapp-l3
LWAPP Control Message	lwapp-cntl
Lightweight Mesh (v1.1.1)	lwm
Lightweight M2M TLV	lwm2mtlv
Light Weight DNS RESolver (BIND9)	lwres
M2 Application Protocol	m2ap
MTP2 Peer Adaptation Layer	m2pa
MTP 2 Transparent Proxy	m2tp
MTP 2 User Adaptation Layer	m2ua
M3 Application Protocol	m3ap
MTP 3 User Adaptation Layer	m3ua
IEEE 1722 MAAP Protocol	maap
MAC-LTE	mac-lte
mac-lte-framed	mac-lte-framed
MAC-NR	mac-nr
MAC Control	macc
802.1AE Security tag	macsec
MikroTik MAC-Telnet Protocol	mactelnet
Blubster/Piolet MANOLITO Protocol	manolito
Marker	marker
Matter	matter
Media Agnostic USB	mausb
Mobile Broadband Interface Model	mbim
.NET Message Framing Protocol	mc-nmf
Miscabling Protocol	mcp
Minecraft Pocket Edition	mcpe
MCTP	mctp
MCTP Control Protocol	mctpc
Multi-Drop Bus	mdb
Meraki Discovery Protocol	mdp
MDS Header	mdshdr
Media Type	media
MEGACO	megaco
Memcache Protocol	memcache
Mesh Header	mesh
Message Analyzer WFP Capture v4	message_analyzer.wfp_capture.v4
Message Analyzer WFP Capture2 v4	message_analyzer.wfp_capture2.v4
Message Analyzer WFP Capture v6	message_analyzer.wfp_capture.v6
Message Analyzer WFP Capture2 v6	message_analyzer.wfp_capture2.v6
Message Analyzer WFP Capture AUTH v4	message_analyzer.wfp_capture.auth.v4
Message Analyzer WFP Capture AUTH v6	message_analyzer.wfp_capture.auth.v6
ETW WFP Capture	etw.wfp_capture
ETW Ndis	etw.ndis
Media Type: message/http	message-http
Metadata	meta
Metamako ethernet trailer	metamako
Media Gateway Control Protocol	mgcp
DCE/RPC Remote Management	mgmt
NXP MiFare	mifare
Media-Independent Handover	mih
Multimedia Internet KEYing	mikey
Cisco FabricPath	cfp
MIME file	mime_dlt
Media Independent Network Transport	mint
Media Independent Network Transport Data	mint_data
Unreliable Multicast Inter-ORB Protocol	miop
Mobile IP	mip
Mobile IPv6	mipv6
MIPv6 Option - Pad1	mip6.options.pad1
MIPv6 Option - PadN	mip6.options.padn
MIPv6 Option - Binding Refresh Advice	mip6.options.bra
MIPv6 Option - Alternate Care-of Address	mip6.options.acoa
MIPv6 Option - Nonce Indices	mip6.options.ni
MIPv6 Option - Authorization Data	mip6.options.bad_auth
MIPv6 Option - Mobile Network Prefix	mip6.options.mnp
MIPv6 Option - Mobility Header Link-Layer Address	mip6.options.mhlla
MIPv6 Option - Mobile Node Identifier	mip6.options.mnid
MIPv6 Option - AUTH-OPTION-TYPE	mip6.options.auth
MIPv6 Option - MESG-ID-OPTION-TYPE	mip6.options.mseg_id
MIPv6 Option - CGA Parameters Request	mip6.options.cgapr
MIPv6 Option - CGA Parameters	mip6.options.cgar
MIPv6 Option - Signature	mip6.options.sign
MIPv6 Option - Permanent Home Keygen Token	mip6.options.phkt
MIPv6 Option - Care-of Test Init	mip6.options.coti
MIPv6 Option - Care-of Test	mip6.options.cot
MIPv6 Option - DNS-UPDATE-TYPE	mip6.options.dnsu
MIPv6 Option - Experimental	mip6.options.em
MIPv6 Option - Vendor Specific	mip6.options.vsm
MIPv6 Option - Service Selection	mip6.options.ssm
MIPv6 Option - Binding Authorization Data for FMIPv6 (BADF)	mip6.options.badff
MIPv6 Option - Home Network Prefix	mip6.options.hnp
MIPv6 Option - Handoff Indicator	mip6.options.hi
MIPv6 Option - Access Technology Type Option	mip6.options.att
MIPv6 Option - Mobile Node Link-layer Identifier	mip6.options.mnlli
MIPv6 Option - Link-local Address	mip6.options.lla
MIPv6 Option - Timestamp	mip6.options.ts
MIPv6 Option - Restart Counter	mip6.options.rc
MIPv6 Option - IPv4 Home Address	mip6.options.ipv4ha
MIPv6 Option - IPv4 Address Acknowledgement	mip6.options.ipv4aa
MIPv6 Option - NAT Detection	mip6.options.natd
MIPv6 Option - IPv4 Care-of Address	mip6.options.ipv4coa
MIPv6 Option - GRE Key	mip6.options.grek
MIPv6 Option - Mobility Header IPv6 Address/Prefix	mip6.options.mhipv6ap
MIPv6 Option - Binding Identifier	mip6.options.bi
MIPv6 Option - IPv4 Home Address Request	mip6.options.ipv4hareq
MIPv6 Option - IPv4 Home Address Reply	mip6.options.ipv4harep
MIPv6 Option - IPv4 Default-Router Address	mip6.options.ipv4dra
MIPv6 Option - IPv4 DHCP Support Mode	mip6.options.ipv4dsm
MIPv6 Option - Context Request	mip6.options.cr
MIPv6 Option - Mobile Node Link-local Address Interface Identifier	mip6.options.lmaa
MIPv6 Option - Redirect-Capability	mip6.options.recap
MIPv6 Option - Redirect	mip6.options.redir
MIPv6 Option - Load Information	mip6.options.load_inf
MIPv6 Option - Alternate IPv4	mip6.options.alt_ip4
MIPv6 Option - Mobile Node Group Identifier	mip6.options.mng
MIPv6 Option - MAG IPv6 Address	mip6.options.mag_ipv6
MIPv6 Option - Access Network Identifier	mip6.options.acc_net_id
MIPv6 Option - Delegated Mobile Network Prefix	mip6.options.dmnp
MACsec Key Agreement	mka
Mesh Link Establishment	mle
MMS	mms
MMS Message Encapsulation	mmse
Mikrotik Neighbor Discovery Protocol	mndp
Modbus/TCP	mbtcp
Modbus/UDP	mbudp
Modbus RTU	mbrtu
Modbus	modbus
Mojito DHT	mojito
MoldUDP	moldudp
MoldUDP64	moldudp64
Mongo Wire Protocol	mongo
Mount Service	mount
SGI Mount Service	sgimount
PPP Multilink Protocol	mp
ISO/IEC 13818-1	mp2t
MP4 / ISOBMFF file format	mp4
MP4V-ES	mp4v-es
iWARP Marker Protocol data unit Aligned framing	iwarp_mpa
RFC 2250 MPEG1	mpeg1
Moving Picture Experts Group Audio	mpeg-audio
MPEG2 Conditional Access Table	mpeg_ca
MPEG2 Descriptors	mpeg_descr
MPEG2 Program Association Table	mpeg_pat
Moving Picture Experts Group	mpeg
Packetized Elementary Stream	mpeg-pes
MPEG2 Program Map Table	mpeg_pmt
MPEG2 Section	mpeg_sect
MultiProtocol Label Switching Header	mpls
PW Associated Channel Header	pwach
PW MPLS Control Word (generic/preferred)	pwmcw
Management Communication Channel (MCC)	mcc
Multiprotocol Label Switching Echo	mpls-echo
Media Access Control (MAC) Address Withdrawal over Static Pseudowire	mpls_mac
MPLS Direct Loss Measurement (DLM)	mplspmdlm
MPLS Inferred Loss Measurement (ILM)	mplspmilm
MPLS Delay Measurement (DM)	mplspmdm
MPLS Direct Loss and Delay Measurement (DLM+DM)	mplspmdlmdm
MPLS Inferred Loss and Delay Measurement (ILM+DM)	mplspmilmdm
PSC	mpls_psc
MPLS ITU-T Y.1711 OAM	mpls_y1711
PPP MPLS Control Protocol	mplscp
MPLS-TP Fault-Management	mplstp_fm
MPLS-TP Lock-Instruct	mplstp_lock
WebSphere MQ	mq
WebSphere MQ Programmable Command Formats	mqpcf
MQ Telemetry Transport Protocol	mqtt
MQ Telemetry Transport Protocol for Sensor Networks	mqttsn
Media Resource Control Protocol Version 2 (MRCPv2)	mrcpv2
Multicast Router DISCovery protocol	mrdisc
Multiple Mac Registration Protocol	mrp-mmrp
Multiple Stream Reservation Protocol	mrp-msrp
Multiple VLAN Registration Protocol	mrp-mvrp
Multicast Source Discovery Protocol	msdp
Message Pack	msgpack
Microsoft Media Server	msmms
MSNIP: Multicast Source Notification of Interest Protocol	msnip
MS Network Load Balancing	msnlb
MSN Messenger Service	msnms
MS Proxy Protocol	msproxy
MSRCP Protocol	msrcp
Message Session Relay Protocol	msrp
BACnet MS/TP	mstp
Windows Search Protocol	mswsp
Message Transfer Part Level 2	mtp2
Message Transfer Part Level 3	mtp3
Message Transfer Part Level 3 Management	mtp3mg
MUDURL	mudurl
MIME Multipart Media Encapsulation	mime_multipart
MUX27010 Protocol	mux27010
NexusWare C7 MTP	nw_mtp
MySQL Protocol	mysql
Wi-Fi Neighbor Awareness Networking (NAN)	wifi_nan
Nano Cryptocurrency Protocol	nano
Non-Access-Stratum 5GS (NAS)PDU	nas-5gs
Non-Access-Stratum (NAS)PDU	nas-eps
Nasdaq TotalView-ITCH	nasdaq_itch
Nasdaq-SoupTCP version 2.0	nasdaq_soup
NAT Port Mapping Protocol	nat-pmp
Port Control Protocol	portcontrol
3GPP Nb Interface RTP Multiplex	nb_rtpmux
UTRAN Iub interface NBAP signalling	nbap
Network Block Device	nbd
Network-Based IP Flow Mobility	nbifom
NetBIOS over IPX	nbipx
NetBIOS Name Service	nbns
NetBIOS Datagram Service	nbdgm
NetBIOS Session Service	nbss
NetWare Core Protocol	ncp
Novell Cluster Services	ncs
NCSI	ncsi
Network Data Management Protocol	ndmp
Nortel Discovery Protocol	ndp
Novell Distributed Print System	ndps
SPNEGO Extended Negotiation Security Mechanism	negoex
netANALYZER	netanalyzer
NetBIOS	netbios
Netdump Protocol	netdump
Cisco NetFlow/IPFIX	cflow
Linux netlink protocol	netlink
Linux Generic Netlink protocol	genl
Linux net_dm (network drop monitor) protocol	net_dm
Linux netlink netfilter protocol	netlink-netfilter
Linux 802.11 Netlink	nl80211
Linux psample protocol	psample
Linux rtnetlink (route netlink) protocol	netlink-route
Linux netlink sock diag protocol	netlink-sock_diag
Network Monitor Header	netmon_header
Network Monitor Event	netmon_event
Network Monitor Filter	netmon_filter
Network Monitor Network Info	netmon_network_info
Network Monitor System Trace	netmon_system_trace
Network Monitor System Config	netmon_system_config
Network Monitor Process	netmon_process
NetMon 802.11 capture header	netmon_802_11
Netrix Communication Protocol	netrix
Amateur Radio NET/ROM	netrom
Monotone Netsync	netsync
HP-UX Network Tracing and Logging	nettl
Microsoft Exchange New Mail Notification	newmail
Nfapi	nfapi
Linux Netfilter NFLOG	nflog
Network File System	nfs
Unknown NFS	nfs.unknown
SVR4	nfs.svr4
KNFSD_LE	nfs.knfsd_le
NFSD_LE	nfs.nfsd_le
KNFSD_NEW	nfs.knfsd_new
ONTAP_V3	nfs.ontap_v3
ONTAP_V4	nfs.ontap_v4
ONTAP_GX_V3	nfs.ontap_gx_v3
CELERRA_VNX	nfs.celerra_vnx
GLUSTER	nfs.gluster
dCache	nfs.dcache
Primary_Data	nfs.primary_data
Network File System CB	nfs.cb
NFSACL	nfsacl
NFSAUTH	nfsauth
NG Application Protocol	ngap
Netgear Ensemble Protocol	nge
NBMA Next Hop Resolution Protocol	nhrp
NIS+	nisplus
NIS+ Callback	nispluscb
NIST_CSOR	nist_csor
3com Network Jack	njack
Network Lock Manager Protocol	nlm
NetWare Link Services Protocol	nlsp
Novell Modular Authentication Service	nmas
Name Management Protocol over IPX	nmpi
.NET NegotiateStream Protocol	ms-nns
Network News Transfer Protocol	nntp
NOE Protocol	noe
H221NonStandard	h221nonstd
nRF Sniffer for Bluetooth LE	nordic_ble
Negative-acknowledgment Oriented Reliable Multicast	norm
Novell PKIS ASN.1 type	novell_pkis
NetPerfMeter Protocol	netperfmeter
NR Radio Resource Control (RRC) protocol	nr-rrc
NR Positioning Protocol A (NRPPa)	nrppa
NetScaler Trace	ns
NetScape Certificate Extensions	ns_cert_exts
NetScaler HA Protocol	nstrace.ha
NetScaler Metric Exchange Protocol	nstrace.mep
NetScaler RPC Protocol	nstrace.rpc
Network Service Header	nsh
GPRS Network Service	gprs-ns
Juniper Netscreen Redundant Protocol	nsrp
NTLM Secure Service Provider	ntlmssp
Network Time Protocol	ntp
Null/Loopback	null
NVM Express	nvme
NVMe-MI	nvme-mi
NVM Express Fabrics RDMA	nvme-rdma
NVM Express Fabrics TCP	nvme-tcp
Neighborhood Watch Protocol	nwp
NXP 802.15.4 Sniffer Protocol	nxp_802154_sniffer
OAMPDU	oampdu
OBD-II PID	obd-ii
OBEX Protocol	obex
OBEX Raw Application Parameters	obex.parameter.raw
Bluetooth OBEX BPP Application Parameters	obex.parameter.bt.bpp
Bluetooth OBEX BIP Application Parameters	obex.parameter.bt.bip
Bluetooth OBEX MAP Application Parameters	obex.parameter.bt.map
Bluetooth OBEX GPP Application Parameters	obex.parameter.bt.gpp
Bluetooth OBEX CTN Application Parameters	obex.parameter.bt.ctn
Bluetooth OBEX PBAP Application Parameters	obex.parameter.bt.pbap
OCFS2 Networking	ocfs2
Open Control Protocol (OCP.1/AES70)	ocp1
Online Certificate Status Protocol	ocsp
Octet Encoding Rules (ASN.1)	oer
OICQ - IM software, popular in China	oicq
Open IPTV Forum CSPG-CI+	oipf.ciplus
OpenBSD Packet Filter log file, pre 3.4	pflog-old
Optimized Link State Routing Protocol	olsr
ISC Object Management API	omapi
OMRON FINS Protocol	omron
Intel Omni-Path	opa
Intel Omni-Path FE Header - Omni-Path Fabric Executive Header	opa.fe
Intel Omni-Path MAD	opa.mad
Intel Omni-Path SnC - Omni-Path Snoop and Capture MetaData Header	opa.snc
OpenFlow	openflow
OpenFlow 1.0	openflow_v1
OpenFlow 1.3	openflow_v4
OpenFlow 1.4	openflow_v5
OpenFlow 1.5	openflow_v6
openSAFETY	opensafety
openSAFETY over UDP	opensafety_udp
OpenThread	openthread
OpenVPN Protocol	openvpn
OpenWire	openwire
Open Policy Service Interface	opsi
OptoMMP	optommp
Opus Interactive Audio Codec	opus
O-RAN Fronthaul CUS	oran_fh_cus
Open Sound Control Encoding	osc
Object Security for Constrained RESTful Environments	oscore
OSI	osi
PPP OSI Network Layer Control Protocol	osinlcp
Align-NPDU	osinlcp.opt.def_pid
OsmoTRX Data Protocol	osmo_trxd
OsmoTRX Control / Clock Protocol	osmo_trxc
GSM multiplexing for AMR	osmux
Open Shortest Path First	ospf
OSSP	ossp
OUCH	ouch
DCOM OXID Resolver	oxid
X.411 Message Transfer Service	p1
X.411 Message Access Service	p3
X.420 Information Object	p22
Wi-Fi Peer-to-Peer	wifi_p2p
X.413 Message Store Service	p7
STANAG 4406 Message	p772
P_Mul (ACP142)	p_mul
PacketBB Protocol	packetbb
PacketCable AVPs	packetcable_avps
PacketLogger	packetlogger
Port Aggregation Protocol	pagp
Paltalk Messenger Protocol	paltalk
Protocol for carrying Authentication for Network Access	pana
PPP Password Authentication Protocol	pap
Aruba PAPI	papi
Pathport Protocol	pathport
UTRAN Iupc interface Positioning Calculation Application Part (PCAP)	pcap
pcap/pcapng packet data	pcap_pktdata
PCAPNG File Format	file-pcapng
Pcapng block	pcapng
PCAPNG Darwin Process Information Block	pcapng.darwin
Path Computation Element communication Protocol	pcep
Packet Cable Lawful Intercept	pcli
Packet Cable Lawful Intercept (8 byte CCCID)	pcli8
Packet Cable Lawful Intercept (timestamp)	pcli12
Packet Cable Lawful Intercept (timestamp, case ID)	pcli20
PC NFS	pcnfsd
PCOM/TCP	pcomtcp
PCOM ASCII	pcomascii
PCOM BINARY	pcombinary
Performance Co-Pilot	pcp
PDC Protocol	pdc
PDCP-LTE	pdcp-lte
PDCP-NR	pdcp-nr
SDAP	sdap
PDU Transport Protocol	pdu_transport
Protected Extensible Authentication Protocol	peap
AiroPeek/OmniPeek encapsulated IEEE 802.11	peekremote
Packed Encoding Rules (ASN.1 X.691)	per
Packet Forwarding Control Protocol	pfcp
OpenBSD Packet Filter log file	pflog
Pragmatic General Multicast	pgm
PostgreSQL	pgsql
Protocol Independent Multicast	pim
Ping Pong Protocol	pingpongprotocol
Microsoft Windows Lanman Remote API Protocol	lanman
PKCS#1	pkcs-1
PKCS10 Certification Request	pkcs10
PKCS#12: Personal Information Exchange	pkcs12
PKINIT	pkinit
PKIX1Explicit	pkix1explicit
PKIX1Implitit	pkix1implicit
PKIX Attribute Certificate	pkixac
PKIXProxy (RFC3820)	pkixproxy
PKIX Qualified	pkixqualified
PKIX Time Stamp Protocol	pkixtsp
PacketCable Call Content Connection	pkt_ccc
PKTAP packet header	pktap
PacketCable	pktc
PacketCable MTA FQDN	pktc.mtafqdn
Linux Kernel Packet Generator	pktgen
Performance Co-Pilot Proxy	pmproxy
NXP PN532	pn532
NXP PN532 HCI	pn532_hci
Portable Network Graphics	png
Peer Name Resolution Protocol	pnrp
Post Office Protocol	pop
Portmap	portmap
Proprietary PCAP	ppcap
PPI Packet Header	ppi
PPI antenna decoder	ppi_antenna
PPI Geotagging GPS tag decoder	ppi_gps
PPI sensor decoder	ppi_sensor
PPI vector decoder	ppi_vector
Point-to-Point Protocol	ppp
PPP In HDLC-Like Framing	ppp_hdlc
PPP Multiplexing	pppmux
PPPMux Control Protocol	pppmuxcp
Default Protocol ID	pppmuxcp.opt.def_pid
PPP-over-Ethernet	pppoe
PPP-over-Ethernet Discovery	pppoed
PPP-over-Ethernet Session	pppoes
Point-to-Point Tunnelling Protocol	pptp
ISO 8823 OSI Presentation Protocol	pres
ISO 9576-1 OSI Connectionless Presentation Protocol	clpres
Protocol Buffers	protobuf
Protocol Buffers (as JSON Mapping View)	protobuf_json
PROXY Protocol	proxy
Parallel Redundancy Protocol (IEC62439 Part 3)	prp
Precision Time Protocol (IEEE1588)	ptp
Picture Transfer Protocol Over IP	ptpip
PULSE protocol for Linux Virtual Server redundancy	pulse
Parallel Virtual File System	pvfs
MPLS PW ATM N-to-One encapsulation, with CW	mplspwatmn1cw
MPLS PW ATM One-to-One or AAL5 PDU encapsulation	mplspwatm11_or_aal5pdu
MPLS PW ATM AAL5 CPCS-SDU mode encapsulation	mplspwatmaal5sdu
MPLS PW ATM N-to-One encapsulation, no CW	mplspwatmn1nocw
MPLS PW ATM Control Word	mplspwatmcontrolword
MPLS PW ATM Cell Header	mplspwatmcellheader
ATM Cell	mplspwatmcell
CESoPSN basic NxDS0 mode (no RTP support)	pwcesopsn
PW Ethernet Control Word	pwethcw
Ethernet PW (no CW)	pwethnocw
Ethernet PW (CW heuristic)	pwethheuristic
PW Frame Relay DLCI Control Word	pwfr
HDLC PW, FR port mode (no CW)	pw_hdlc_nocw_fr
HDLC-like framing for PPP	pw_hdlc_nocw_hdlc_ppp
Pseudo-Wire OAM	pw_oam
Pseudowire Padding	pw.padding
SAToP	pwsatopcw
H.248 Q.1950 Annex A	h248q1950
Q.2931	q2931
ITU-T Q.708 ISPC Analysis	q708
Q.931	q931
Q.932	q932
Q.932 Operations Service Element	q932.ros
Q.933	q933
Qualified Logical Link Control	qllc
QNX6 QNET LWL4 protocol	lwl4
QNX6 QNET QOS protocol	qos
QNX6 QNET LR protocol	lr
QNX6 QNET KIF protocol	kif
QNX6 QNET Network Resolver protocol	nr
QSIG	qsig
Quake Network Protocol	quake
Quake II Network Protocol	quake2
Quake III Arena Network Protocol	quake3
QuakeWorld Network Protocol	quakeworld
QUIC IETF	quic
R09.x	r09
Assa Abloy R3	r3
IEEE 802.11 Radiotap Capture header	radiotap
RADIUS Protocol	radius
RakNet game networking protocol	raknet
Radio Access Network Application Part	ranap
Raw packet data	raw
Ruby Marshal Object	rbm
DCE/RPC Directory Acl Interface	rdaclif
Remote Device Management	rdm
Remote Desktop Protocol	rdp
RDP clipboard redirection channel Protocol	rdp_cliprdr
RDP Dynamic Channel Protocol	rdp_drdynvc
RDP Graphic pipeline channel Protocol	rdp_egfx
RDP Program virtual channel Protocol	rdp_rail
RDP audio output virtual channel Protocol	rdp_snd
Remote Desktop Protocol Multi-transport	rdpmt
UDP Remote Desktop Protocol	rdpudp
Real Data Transport	rdt
Realtek Layer 2 Protocols	realtek
Realtek Remote Control Protocol	rrcp
Realtek Echo Protocol	rep
Realtek Loop Detection Protocol	rldp
Redback	redback
Redback Lawful Intercept	redbackli
REsource LOcation And Discovery	reload
REsource LOcation And Discovery Framing	reload-framing
DCOM IRemoteActivation	remact
IRemUnknown	remunk
IRemUnknown2	remunk2
DCE DFS Replication Server	rep_proc
REdis Serialization Protocol	resp
Retix Spanning Tree Protocol	r-stp
H.263 RTP Payload header (RFC2190)	rfc2190
RFC 7468 file format	rfc7468
RFtap Protocol	rftap
Router-port Group Management Protocol	rgmp
Riemann	riemann
Routing Information Protocol	rip
RIPng	ripng
Radio Link Control	rlc
RLC-LTE	rlc-lte
RLC-NR	rlc-nr
Redundant Link Management Protocol	rlm
Rlogin Protocol	rlogin
Remote Management Control Protocol	rmcp
Java RMI	rmi
Java Serialization	serialization
HP Remote Maintenance Protocol	rmp
Forward Error Correction (FEC)	rmt-fec
Layered Coding Transport	rmt-lct
UTRAN Iur interface Radio Network Subsystem Application Part	rnsap
RObust Header Compression (ROHC)	rohc
Roofnet Protocol	roofnet
Roon Discovery	roon_disco
X.880 OSI Remote Operations Service	ros
Remote Override interface	roverride
Remote Procedure Call	rpc
Remote Packet Capture	rpcap
RPC over RDMA	rpcordma
RPKI-Router Protocol	rpkirtr
Remote Program Load	rpl
Privilege Server operations	rpriv
Remote Quota	rquota
Radio Resource Control (RRC) protocol	rrc
Radio Resource LCS Protocol (RRLP)	rrlp
DCE/RPC RS_ACCT	rs_acct
Registry Server Attributes Manipulation Interface	rs_attr
DCE/RPC Registry Server Attributes Schema	rs_attr_schema
DCE/RPC RS_BIND	rs_bind
DCE/RPC RS_MISC	rs_misc
DCE Name Service	rs_pgo
DCE/RPC RS_PROP_ACCT	rs_prop_acct
DCE/RPC Registry server propagation interface - ACLs	rs_prop_acl
DCE/RPC Prop Attr	rs_prop_attr
DCE/RPC Registry server propagation interface - PGO items	rs_prop_pgo
DCE/RPC Registry server propagation interface - properties and policies	rs_prop_plcy
DCE/RPC Registry Password Management	rs_pwd_mgmt
Registry server administration operations.	rs_repadm
DCE/RPC Repserver Calls	rs_replist
DCE/RPC Operations between registry server replicas	rs_repmgr
DCE/RPC RS_UNIX	rs_unix
Remote sec_login preauth interface.	rsec_login
Remote Shell	rsh
Realm Specific IP Protocol	rsip
Radio Signalling Link (RSL)	gsm_abis_rsl
RMCP Security-extensions Protocol	rsp
RSTAT	rstat
Remote Shared Virtual Disk	rsvd
Resource ReserVation Protocol (RSVP)	rsvp
Resource ReserVation Protocol (RSVP-E2EI)	rsvp-e2ei
RSYNC File Synchroniser	rsync
RTAC Serial	rtacser
802.1cb R-TAG	rtag
WebRTC Datachannel Protocol	rtcdc
RTcfg	rtcfg
Real-time Transport Control Protocol	rtcp
Secure Real-time Transport Control Protocol	srtcp
RTI TCP Transport Protocol	rtitcp
Real Time Location System	rtls
Real-Time Media Access Control	rtmac
TDMA RTmac Discipline	tdma
Real Time Messaging Protocol	rtmpt
Real-Time Transport Protocol	rtp
RTP Payload for Redundant Audio Data (RFC 2198)	rtp_rfc2198
Real-Time Transport Protocol ED137 Extensions	rtp.ext.ed137
RFC 2833 RTP Event	rtpevent
RFC 4695/6295 RTP-MIDI	rtpmidi
RTPDump file format	rtpdump
Sippy RTPproxy Protocol	rtpproxy
Real-Time Publish-Subscribe Wire Protocol	rtps
Real-Time Publish-Subscribe Wire Protocol (processed)	rtpsproc
Real-Time Publish-Subscribe Virtual Transport	rtpsvt
X.228 OSI Reliable Transfer Service	rtse
Real Time Streaming Protocol	rtsp
UTRAN Iuh interface RUA signalling	rua
Reliable UDP	rudp
Remote Wall protocol	rwall
RX Protocol	rx
S1 Application Protocol	s1ap
STANAG 5066 (SIS layer)	s5066sis
STANAG 5066(DTS layer)	s5066dts
S7 Communication	s7comm
UTRAN IuBC interface SABP signaling	sabp
SADMIND	sadmind
Sametime Protocol	sametime
Session Announcement Protocol	sap
SAP NI Protocol	sapni
SAP Diag Protocol	sapdiag
SAP Enqueue Protocol	sapenqueue
SAP HANA SQL Command Network Protocol	saphdb
SAP Internet Graphic Server	sapigs
SAP Message Server Protocol	sapms
SAP Router Protocol	saprouter
SAP SNC Protocol	sapsnc
Server/Application State Protocol	sasp
SBAS L1 Navigation Message	sbas_l1
Bluetooth SBC Codec	sbc
SBc Application Part	sbcap
SAIA S-Bus	sbus
Signalling Connection Control Part	sccp
Signalling Connection Control Part Management	sccpmg
ZigBee SCoP	scop
SCSI	scsi
SCSI_MMC	scsi_mmc
SCSI_OSD	scsi_osd
SCSI_SBC	scsi_sbc
SCSI_SMC	scsi_smc
SCSI_SSC	scsi_ssc
SCTE-35 Splice Information	scte35
SCTE-35 Private Command	scte35_private_command
SCTE-35 Splice Insert	scte35_si
SCTE-35 Splice Schedule	scte35_splice_schedule
SCTE-35 Time Signal	scte35_time
Stream Control Transmission Protocol	sctp
Scylla RPC protocol	scylla
SDH/SONET Protocol	sdh
Synchronous Data Link Control (SDLC)	sdlc
Session Description Protocol	sdp
SEBEK - Kernel Data Capture	sebek
DCE Security ID Mapper	secidmap
SEL Protocol	selfm
SERCOS III V1.1	siii
ISO 8327-1 OSI Session Protocol	ses
InMon sFlow	sflow
SSH File Transfer Protocol	sftp
SGs Application Part (SGsAP)	sgsap
Secure Host IP Configuration Protocol	shicp
Shim6 Protocol	shim6
Signaling Compression	sigcomp
Decompressed SigComp message as raw text	raw_sigcomp
Signal PDU	signal_pdu
Standard Interface for Multiple Platform Link Evaluation	simple
SIMULCRYPT Protocol	simulcrypt
Session Initiation Protocol	sip
Session Initiation Protocol (SIP as raw text)	raw_sip
Sipfrag	sipfrag
WAP Session Initiation Request	wap-sir
Societe Internationale de Telecommunications Aeronautiques	sita
Skinny Client Control Protocol	skinny
SKYPE	skype
Cisco SLARP	slarp
SliMP3 Communication Protocol	slimp3
Linux cooked-mode capture	sll
Slow Protocols	slow
SoulSeek Protocol	slsk
Cisco Session Management	sm
SMB (Server Message Block Protocol)	smb
SMB2 (Server Message Block Protocol version 2)	smb2
Microsoft Windows Browser Protocol	browser
SMB-Direct (SMB RDMA Transport)	smb_direct
Microsoft Windows Logon Protocol (Old)	smb_netlogon
SMB MailSlot Protocol	mailslot
SMB Pipe Protocol	smb_pipe
Shared Memory Communications	smc
Smart Message Language	sml
Session Multiplex Protocol	smp
Short Message Peer to Peer	smpp
Short Message Relaying Service	smrse
Simple Mail Transfer Protocol	smtp
SNMP Multiplex Protocol	smux
Systems Network Architecture	sna
Systems Network Architecture XID	sna_xid
SNA-over-Ethernet	snaeth
Subnetwork Dependent Convergence Protocol	sndcp
Subnetwork Dependent Convergence Protocol XID	sndcpxid
Simple Network Management Protocol	snmp
Snort Alerts	snort
Controller Area Network	can
Controller Area Network FD	canfd
Socks Protocol	socks
SolarEdge monitoring protocol	solaredge
SOME/IP Protocol	someip
SOME/IP Service Discovery Protocol	someipsd
SoupBinTCP	soupbintcp
SparkplugB	sparkplugb
SPDY	spdy
Spice protocol	spice
Simple Protected Negotiation	spnego
SPNEGO-KRB5	spnego-krb5
Sequenced Packet Protocol	spp
SPRAY	spray
Simple Packet Relay Transport	sprt
H.324/SRP	srp
SRT Protocol	srt
Service Location Protocol	srvloc
SSCF-NNI	sscf-nni
SSCOP	sscop
SSH Protocol	ssh
Scripting Service Protocol	ssp
Novell SecretStore Services	sss
Secure Socket Tunneling Protocol	sstp
State Synchronization Protocol	ssyncp
SMPTE ST2110-20 (Uncompressed Active Video)	st2110_20
STANAG 4607 (GMTI Format)	s4607
StarTeam	starteam
Network Status Monitor Protocol	stat
Network Status Monitor CallBack Protocol	statnotify
Spirent Test Center Signature	stcsig
Steam In-Home Streaming Discovery Protocol	steam_ihs_discovery
Stateless Transport Tunneling	stt
Session Traversal Utilities for NAT	stun
SS7 SCCP-User Adaptation Layer	sua
IEC61850 Sampled Values	sv
swIPe IP Security Protocol	swipe
Symantec Enterprise Firewall	symantec
MBMS synchronisation protocol	sync
Synergy	synergy
IEEE C37.118 Synchrophasor Protocol	synphasor
Sysdig Event	sysdig
MIDI System Exclusive	sysex
MIDI System Exclusive DigiTech	sysex_digitech
Syslog message	syslog
systemd Journal Entry	systemd_journal
GENERIC-CONFERENCE-CONTROL T.124	t124
MULTIPOINT-COMMUNICATION-SERVICE T.125	t125
T.30	t30
T.38	t38
TACACS	tacacs
TACACS+	tacplus
Transport Adapter Layer Interface v1.0, RFC 3094	tali
Trapeze Access Point Access Protocol	tapa
Transaction Capabilities Application Part	tcap
TCG_CP_OIDS	tcg_cp_oids
Transmission Control Protocol	tcp
TCP Option - No-Operation (NOP)	tcp.options.nop
TCP Option - End of Option List (EOL)	tcp.options.eol
TCP Option - Timestamps	tcp.options.timestamp
TCP Option - Maximum segment size	tcp.options.mss
TCP Option - Window scale	tcp.options.wscale
TCP Option - SACK permitted	tcp.options.sack_perm
TCP Option - SACK	tcp.options.sack
TCP Option - Echo	tcp.options.echo
TCP Option - Echo reply	tcp.options.echoreply
TCP Option - CC	tcp.options.cc
TCP Option - CC.NEW	tcp.options.ccnew
TCP Option - CC.ECHO	tcp.options.ccecho
TCP Option - TCP AO	tcp.options.ao
TCP Option - TCP MD5 signature	tcp.options.md5
TCP Option - SCPS capabilities	tcp.options.scps
TCP Option - Selective Negative Acknowledgment	tcp.options.snack
TCP Option - SCPS record boundary	tcp.options.scpsrec
TCP Option - SCPS corruption experienced	tcp.options.scpscor
TCP Option - Quick-Start	tcp.options.qs
TCP Option - User Timeout	tcp.options.user_to
TCP Option - TCP Fast Open	tcp.options.tfo
TCP Option - Accurate ECN	tcp.options.acc_ecn
TCP Option - Riverbed Probe	tcp.options.rvbd.probe
TCP Option - Riverbed Transparency	tcp.options.rvbd.trpy
TCP Option - Experimental	tcp.options.experimental
TCP Option - Unknown	tcp.options.unknown
Multipath Transmission Control Protocol	mptcp
DTN TCP Convergence Layer Protocol	tcpcl
TCPCL Extension Subdissectors	tcpcl_exts
TCP Encapsulation of IPsec Packets	tcpencap
TCP based Robot Operating System protocol (TCPROS)	tcpros
Digium TDMoE Protocol	tdmoe
TDMoP protocol	tdmop
Tabular Data Stream	tds
Tunnel Extensible Authentication Protocol	teap
Technically Enhanced Capture Module Protocol	tecmp
Technically Enhanced Capture Module Protocol Payload	tecmp.payload
TEI Management Procedure, Channel D (LAPD)	tei_management
TEKLINK	teklink
Telkonet powerline	telkonet
Telnet	telnet
Teredo IPv6 over UDP tunneling	teredo
TETRA Protocol	tetra
Line-based text data	data-text-lines
Tinkerforge Protocol	tfp
Trivial File Transfer Protocol	tftp
Thread	thread
Thread Address	thread_address
Thread Beacon	thread_bcn
Thread CoAP	thread_coap
Thread Diagnostics	thread_diagnostic
Thread MeshCoP	thread_meshcop
Thread Network Data	thread_nwd
Thrift Protocol	thrift
Tibia Protocol	tibia
Tagged Image File Format	tiff
Time Protocol	time
Transparent Inter Process Communication(TIPC)	tipc
TiVoConnect Discovery Protocol	tivoconnect
DCE DFS Token Server	tkn4int
Transport Layer Security	tls
TN3270 Protocol	tn3270
TN5250 Protocol	tn5250
Transport-Neutral Encapsulation Format	tnef
Transparent Network Substrate Protocol	tns
Alteon - Transparent Proxy Cache Protocol	tpcp
TPKT - ISO on TCP - RFC1006	tpkt
TPKT Heuristic (for RDP)	tpkt
TP-Link Smart Home Protocol	tplink-smarthome
TPM2.0 Protocol	tpm
AudioCodes TPNCP (TrunkPack Network Control Protocol)	tpncp
Token-Ring	tr
Train Realtime Data Protocol	trdp
TRILL	trill
Token-Ring Media Access Control	trmac
Teamspeak2 Protocol	ts2
TeamSpeak3 DNS	tsdns
Time Synchronization Protocol	tsp
Cisco ttag	ttag
TTEthernet	tte
TTEthernet Protocol Control Frame	tte_pcf
Turbocell Header	turbocell
Turbocell Aggregate Data	turbocell_aggregate
TURN Channel	turnchannel
BEA Tuxedo	tuxedo
TwoWay Active Measurement Test Protocol	twamp.test
TwoWay Active Measurement Control Protocol	twamp.control
One-way Active Measurement Protocol	owamp.test
Tazmen Sniffer Protocol	tzsp
USB 3 Vision	u3v
UA3G Message	ua3g
Universal Alcatel Protocol	ua
UA/SIP Protocol	uasip
USB Attached SCSI	uasp
UA/UDP Encapsulation Protocol	uaudp
UAVCAN/CAN	uavcan_can
Ubiquiti Discovery Protocol	ubdp
Ubertooth	ubertooth
DCE DFS FLDB UBIK TRANSFER	ubikdisk
DCE DFS FLDB UBIKVOTE	ubikvote
Aruba UBT	ubt
UBX Protocol	ubx
GPS L1 Navigation Message	gps_l1
UWB UCI Protocol	uci
Universal Computer Protocol	ucp
Unidirectional Link Detection	udld
User Datagram Protocol	udp
Lightweight User Datagram Protocol	udplite
UDPCP	udpcp
UDP Encapsulation of IPsec Packets	udpencap
Unified Diagnostic Services	uds
UDT Protocol	udt
UDP based FTP w/ multicast	uftp
UDP based FTP w/ multicast V4	uftp4
UDP based FTP w/ multicast V5	uftp5
UHD	uhd
OMA UserPlane Location Protocol	ulp
Unlicensed Mobile Access	uma
MAC	mac
USB	usb
USBPort	usbport
USB Audio	usbaudio
USB Communications and CDC Control	usbcom
USB Device Firmware Upgrade 	usbdfu
USB HID	usbhid
USB HUB	usbhub
X-Rite i1 Display Pro (and derivatives) USB protocol	i1d3
USB Mass Storage Class	usbmsclass
USB Printer	usbprinter
USB Video	usbvideo
USBIP Protocol	usbip
USB Link Layer	usbll
USB Mass Storage	usbms
DLT User	user_dlt
UserLog Protocol	userlog
Unisys Transmittal System	uts
Async data over ISDN (V.120)	v120
V.150.1 State Signaling Event	v150fw
V5.2	v52
V5 Data Link Layer	v5dl
V5 Envelope Function (v5ef)	v5ef
V5.2-User Adaptation Layer	v5ua
VCDU	vcdu
VSI protocol	vdp21
LeCroy VICP	vicp
Banyan Vines ARP	vines_arp
Banyan Vines Echo	vines_echo
Banyan Vines Fragmentation Protocol	vines_frp
Banyan Vines ICP	vines_icp
VINES	vines
Banyan Vines IP	vines_ip
Banyan Vines IPC	vines_ipc
Banyan Vines LLC	vines_llc
Banyan Vines RTP	vines_rtp
Banyan Vines SPP	vines_spp
Van Jacobson PPP compression	vjc
802.1Q Virtual LAN	vlan
VMware Lab Manager	vmlab
VMware - HeartBeat	vmware_hb
Virtual Network Computing	vnc
VN-Tag	vntag
VP8	vp8
VP9	vp9
VPP Dispatch Trace	vpp
VPP Buffer Metadata	vpp-metadata
VPP Buffer Opaque	vpp-opaque
VPP Buffer Opaque2	vpp-opaque2
VPP Buffer Trace	vpp-trace
Virtual Router Redundancy Protocol	vrrp
VITA 49 radio transport protocol	vrt
Video Services over IP	vsip
Vendor Specific Control Protocol	vsncp
PDN Identifier	vsncp.opt.pdnid
Access Point Name	vsncp.opt.apname
PDN Type	vsncp.opt.pdntype
PDN Address	vsncp.opt.pdnaddress
Protocol Configuration Options	vsncp.opt.pco
Error Code	vsncp.opt.errorcode
Attach Type	vsncp.opt.attachtype
IPv4 Default Router Address	vsncp.opt.ipv4address
Address Allocation Cause	vsncp.opt.addressalloc
APN Aggregate Maximum Bit Rate(APN-AMBR)	vsncp.opt.apn_ambr
IPv6 HSGW Link Local Address IID	vsncp.opt.ipv6_hsgw_lla_iid
Vendor Specific Network Protocol	vsnp
vSocket	vsock
VSS Monitoring Ethernet trailer	vssmonitoring
VLAN Trunking Protocol	vtp
Vuze DHT Protocol	vuze-dht
VXI-11 Asynchronous Abort	vxi11_async
VXI-11 Core Protocol	vxi11_core
VXI-11 Interrupt	vxi11_intr
Virtual eXtensible Local Area Network	vxlan
Virtual eXtensible Local Area Network (GPE)	vxlan_gpe
WAI Protocol	wai
Wireless Access Station Session Protocol	wassp
WaveAgent	waveagent
WAP Binary XML	wbxml
Web Cache Communication Protocol	wccp
Wellfleet Compression	wcp
WebSocket	websocket
Wellfleet HDLC	whdlc
WireGuard Protocol	wg
Who	who
whois	whois
Wi-Fi Display	wifi_display
Wi-Fi Device Provisioning Protocol	dpp
WINS (Windows Internet Name Service) Replication	winsrepl
Wi-SUN Field Area Network	wisun
Wi-SUN FAN Security Extension	wisun.sec
Wi-SUN FAN EAPOL Relay	wisun.eapol_relay
Wi-SUN Netricity Segment	wisun.netricity.sc
IEEE 802.11 RSNA EAPOL key	wlan_rsna_eapol
Wlan Certificate Extension	wlancertextn
Cisco Wireless LAN Context Control Protocol	wlccp
Wake On LAN	wol
World of Warcraft	wow
World of Warcraft World	woww
Wifi Protected Setup	wps
WSE remote ethernet	wreth
Wave Short Message Protocol(IEEE P1609.3)	wsmp
Wireless Session Protocol	wsp
Wireless Transport Layer Security	wtls
Wireless Transaction Protocol	wtp
X11	x11
X.25	x25
X.29	x29
EUTRAN X2 Application Protocol (X2AP)	x2ap
X.509 Authentication Framework	x509af
X.509 Certificate Extensions	x509ce
X.509 Information Framework	x509if
X.509 Selected Attribute Types	x509sat
Async data over ISDN (X.75)	x75
Call Specification Language (Xcsl)	xcsl
X Display Manager Control Protocol	xdmcp
eXpressive Internet Protocol	xip
XIP Serval	xipserval
eXtensible Messaging Client Protocol	xmcp
watcherinfo XML doc (RFC 3858)	watcherinfo
poc-settings XML doc (RFC 4354)	poc-settings
rss	rss
XML Configuration Access Protocol Server Capabilities	xcap-caps
Reginfo XML doc (RFC 3680)	reginfo
Event Notification for Resource Lists (RFC 4662)	list
XCAP Error XML doc (RFC 4825)	xcap-error
Media Server Control Markup Language - draft 07	mscml
presence XML doc (RFC 3863)	presence
Synchronized Multimedia Integration Language	smil
iTunes podCast rss elements	itunes
Dublin Core Metadata (DC)	dc
eXtensible Markup Language	xml
XMPP Protocol	xmpp
NG-RAN Xn Application Protocol (XnAP)	xnap
X.25 over TCP	xot
Excentis XRA Header	xra
DOCSIS Segment	docsis_segment
DOCSIS PHY Link Channel	docsis_plc
DOCSIS_NCP	docsis_ncp
DOCSIS_INIT_RANGING	docsis_init_ranging
Enhanced Cash Trading Interface 10.0	xti
Xpress Transport Protocol	xtp
Xyplex	xyplex
YAMI Protocol	yami
Yahoo Messenger Protocol	yhoo
Yahoo YMSG Messenger Protocol	ymsg
Yellow Pages Bind	ypbind
Yellow Pages Passwd	yppasswd
Yellow Pages Service	ypserv
Yellow Pages Transfer	ypxfr
Z21 LAN Protocol	z21
Z39.50 Protocol	z3950
Zabbix Protocol	zabbix
ZigBee Direct	zbd
ZigBee Application Support Layer	zbee_aps
ZigBee Application Framework	zbee_apf
ZigBee Network Layer	zbee_nwk
ZigBee Beacon	zbee_beacon
ZigBee IP Beacon	zbip_beacon
ZigBee IE	zbee_ie
ZigBee Green Power Profile	zbee_nwk_gp
Zigbee TLV	zbee_tlv
ZigBee Cluster Library	zbee_zcl
ZigBee ZCL Alarms	zbee_zcl_general.alarms
ZigBee ZCL Analog Input Basic	zbee_zcl_general.analog.input.basic
ZigBee ZCL Analog Output Basic	zbee_zcl_general.analog.output.basic
ZigBee ZCL Analog Value Basic	zbee_zcl_general.analog.value.basic
ZigBee ZCL Appliance Control	zbee_zcl_general.applctrl
ZigBee ZCL Appliance Events & Alert	zbee_zcl_ha.applevtalt
ZigBee ZCL Appliance Identification	zbee_zcl_ha.applident
ZigBee ZCL Appliance Statistics	zbee_zcl_ha.applstats
ZigBee ZCL Ballast Configuration	zbee_zcl_lighting.ballast_ctrl
ZigBee ZCL Basic	zbee_zcl_general.basic
ZigBee ZCL Binary Input Basic	zbee_zcl_general.binary_input_basic
ZigBee ZCL Binary Output Basic	zbee_zcl_general.binary_output_basic
ZigBee ZCL Binary Value Basic	zbee_zcl_general.binary_value_basic
ZigBee ZCL Calendar	zbee_zcl_se.calendar
ZigBee ZCL Color Control	zbee_zcl_lighting.color_ctrl
ZigBee ZCL Commissioning	zbee_zcl_general.commissioning
ZigBee ZCL Daily Schedule	zbee_zcl_se.daily_schedule
ZigBee ZCL Dehumidification Control	zbee_zcl_hvac.dehum_ctrl
ZigBee ZCL Device Management	zbee_zcl_se.dm
ZigBee ZCL Device Temperature Configuration	zbee_zcl_general.device_temperature_config
ZigBee ZCL Door Lock	zbee_zcl_closures.door_lock
ZigBee ZCL DLRC	zbee_zcl_se.drlc
ZigBee ZCL Electrical Measurement	zbee_zcl_meas_sensing.elecmes
ZigBee ZCL Energy Management	zbee_zcl_se.em
ZigBee ZCL Events	zbee_zcl_se.events
ZigBee ZCL Fan Control	zbee_zcl_hvac.fan_ctrl
ZigBee ZCL Flow Meas.	zbee_zcl_meas_sensing.flowmeas
ZigBee ZCL Green Power	zbee_zcl_general.gp
ZigBee ZCL Groups	zbee_zcl_general.groups
ZigBee ZCL IAS ACE	zbee_zcl_ias.ace
ZigBee ZCL IAS WD	zbee_zcl_ias.wd
ZigBee ZCL IAS Zone	zbee_zcl_ias.zone
ZigBee ZCL Identify	zbee_zcl_general.identify
ZigBee ZCL Illuminance Level Sensing	zbee_zcl_meas_sensing.illumlevelsen
ZigBee ZCL Illuminance Meas.	zbee_zcl_meas_sensing.illummeas
ZigBee ZCL Key Establishment	zbee_zcl_se.ke
ZigBee ZCL Keep-Alive	zbee_zcl_se.keep_alive
ZigBee ZCL Level Control	zbee_zcl_general.level_control
ZigBee ZCL MDU Pairing	zbee_zcl_se.mdu_pairing
ZigBee ZCL Metering	zbee_zcl_se.met
ZigBee ZCL Meter Identification	zbee_zcl_ha.metidt
ZigBee ZCL Messaging	zbee_zcl_se.msg
ZigBee ZCL Multistate Input Basic	zbee_zcl_general.multistate.input.basic
ZigBee ZCL Multistate Output Basic	zbee_zcl_general.multistate.output.basic
ZigBee ZCL Multistate Value Basic	zbee_zcl_general.multistate.value.basic
ZigBee ZCL Occupancy Sensing	zbee_zcl_meas_sensing.occsen
ZigBee ZCL OnOff	zbee_zcl_general.onoff
ZigBee ZCL OnOff Switch Configuration	zbee_zcl_general.onoff.switch.configuration
ZigBee ZCL OTA	zbee_zcl_general.ota
ZigBee ZCL Partition	zbee_zcl_general.part
ZigBee ZCL Poll Control	zbee_zcl_general.poll
ZigBee ZCL Power Configuration	zbee_zcl_general.power_config
ZigBee ZCL Prepayment	zbee_zcl_se.pp
ZigBee ZCL Pressure Meas.	zbee_zcl_meas_sensing.pressmeas
ZigBee ZCL Price	zbee_zcl_se.price
ZigBee ZCL Pump Configuration and Control	zbee_zcl_hvac.pump_config_ctrl
ZigBee ZCL Power Profile	zbee_zcl_general.pwrprof
ZigBee ZCL Rel. Humidity Meas.	zbee_zcl_meas_sensing.relhummeas
ZigBee ZCL RSSI Location	zbee_zcl_general.rssi_location
ZigBee ZCL Scenes	zbee_zcl_general.scenes
ZigBee ZCL Shade Configuration	zbee_zcl_closures.shade_config
ZigBee ZCL Sub-Ghz	zbee_zcl_se.sub_ghz
ZigBee ZCL Temperature Meas.	zbee_zcl_meas_sensing.tempmeas
ZigBee ZCL Thermostat	zbee_zcl_hvac.thermostat
ZigBee ZCL Thermostat User Interface Configuration	zbee_zcl_hvac.thermo_ui_config
ZigBee ZCL Time	zbee_zcl_general.time
ZigBee ZCL Touchlink	zbee_zcl_general.touchlink
ZigBee ZCL Tunneling	zbee_zcl_se.tun
ZigBee Device Profile	zbee_zdp
ZBOSS Network Coprocessor product	zbncp
Zebra Protocol	zebra
ZigBee Encapsulation Protocol	zep
Zipped Inter-ORB Protocol	ziop
ZRTP	zrtp
ZVT Kassenschnittstelle	zvt
WiMAX ASN Control Plane Protocol	wimaxasncp
WiMAX MAC-PHY over Ethernet	wimaxmacphy
PROFINET Real-Time Protocol	pn_rt
PROFINET PTCP	pn_ptcp
PROFINET MRRT	pn_mrrt
PROFINET MRP	pn_mrp
PROFINET IO	pn_io
PROFINET IO (Device)	pn_io_device
PROFINET IO (Controller)	pn_io_controller
PROFINET IO (Supervisor)	pn_io_supervisor
PROFINET IO (Parameter Server)	pn_io_parameterserver
PROFINET IO (Implicit Ar)	pn_io_implicitar
PROFINET IO (Apdu Status)	pn_io_apdu_status
PROFINET IO (Time Aware Status)	pn_io_time_aware_status
PROFINET DCP	pn_dcp
ICBAAccoMgt	cba_acco_mgt
ICBAAccoMgt2	cba_acco_mgt2
ICBAAccoCallback	cba_acco_cb
ICBAAccoCallback2	cba_acco_cb2
ICBAAccoServer	cba_acco_server
ICBAAccoServer2	cba_acco_server2
ICBAAccoServerSRT	cba_acco_server_srt
ICBAAccoSync	cba_acco_sync
ICBAPhysicalDevice	cba_pdev
ICBAPhysicalDevice2	cba_pdev2
ICBABrowse	cba_browse
ICBABrowse2	cba_browse2
ICBAPhysicalDevicePC	cba_pdev_pc
ICBAPhysicalDevicePCEvent	cba_pdev_pc_event
ICBAPersist	cba_persist
ICBAPersist2	cba_persist2
ICBALogicalDevice	cba_ldev
ICBALogicalDevice2	cba_ldev2
ICBAState	cba_state
ICBAStateEvent	cba_state_event
ICBATime	cba_time
ICBAGroupError	cba_grouperror
ICBAGroupErrorEvent	cba_grouperror_event
ICBARTAuto	cba_rtauto
ICBARTAuto2	cba_rtauto2
ICBASystemProperties	cba_sysprop
TwinCAT NV	tc_nv
TwinCAT IO-RAW	ioraw
EtherCAT frame header	ecatf
EtherCAT Switch Link	esl
EtherCAT Mailbox Protocol	ecat_mailbox
EtherCAT datagram(s)	ecat
AMS	ams
DG Gryphon Protocol	gryphon
Meta Analysis Tracing Engine	mate
OpcUa Binary Protocol	opcua
UNISTIM Protocol	unistim
Serial Infrared	sir
IrDA Link Access Protocol	irlap
Log Message	log
IrDA Link Management Protocol	irlmp
Information Access Protocol	iap
Tiny Transport Protocol	ttp
IrCOMM Protocol	ircomm
WiMax Protocol	wmx
WiMax CDMA Code Attribute	wmx.cdma
WiMax Sub-TLV Messages	wmx.sub
WiMax Generic/Type1/Type2 MAC Header Messages	wmx.hdr
WiMax ULMAP Messages	wmx.ulmap
WiMax UCD Messages	wmx.ucd
WiMax SBC-REQ/RSP Messages	wmx.sbc
WiMax RNG-RSP Messages	wmx.rng_rsp
WiMax RNG-REQ Messages	wmx.rng_req
WiMax RES-CMD Message	wmx.res
WiMax REP-REQ/RSP Messages	wmx.rep
WiMax REG-RSP Messages	wmx.reg_rsp
WiMax REG-REQ Messages	wmx.reg_req
WiMax PRC-LT-CTRL Message	wmx.prc_lt_ctrl
WiMax PMC-RSP Messages	wmx.pmc_rsp
WiMax PMC-REQ Messages	wmx.pmc_req
WiMax PKM-REQ/RSP Messages	wmx.pkm
WiMax FPC Message	wmx.fpc
WiMax DSX-RVD Message	wmx.dsx_rvd
WiMax DSD Messages	wmx.dsd
WiMax DSC Messages	wmx.dsc
WiMax DSA Messages	wmx.dsa
WiMax DREG-REQ Messages	wmx.dreg_req
WiMax DREG-CMD Messages	wmx.dreg_cmd
WiMax DLMAP Messages	wmx.dlmap
WiMax DCD Messages	wmx.dcd
WiMax CLK-CMP Message	wmx.clk
WiMax ARQ Feedback/Discard/Reset Messages	wmx.arq
WiMax AAS-FEEDBACK Messages	wmx.aas
WiMax AAS-BEAM Messages	wmx.aas_beam
WiMax MAC Management Message	wmx.mgmt
WiMax Mac to Mac Packet	m2m
TRANSUM RTE Data	transum
Bluetooth GATT Attribute Generic Access (UUID 0x1800)	btgatt.uuid0x1800
Bluetooth GATT Attribute Generic Attribute (UUID 0x1801)	btgatt.uuid0x1801
Bluetooth GATT Attribute Immediate Alert (UUID 0x1802)	btgatt.uuid0x1802
Bluetooth GATT Attribute Link Loss (UUID 0x1803)	btgatt.uuid0x1803
Bluetooth GATT Attribute Tx Power (UUID 0x1804)	btgatt.uuid0x1804
Bluetooth GATT Attribute Current Time (UUID 0x1805)	btgatt.uuid0x1805
Bluetooth GATT Attribute Reference Time Update (UUID 0x1806)	btgatt.uuid0x1806
Bluetooth GATT Attribute Next DST Change (UUID 0x1807)	btgatt.uuid0x1807
Bluetooth GATT Attribute Glucose (UUID 0x1808)	btgatt.uuid0x1808
Bluetooth GATT Attribute Health Thermometer (UUID 0x1809)	btgatt.uuid0x1809
Bluetooth GATT Attribute Device Information (UUID 0x180a)	btgatt.uuid0x180a
Bluetooth GATT Attribute Heart Rate (UUID 0x180d)	btgatt.uuid0x180d
Bluetooth GATT Attribute Phone Alert Status (UUID 0x180e)	btgatt.uuid0x180e
Bluetooth GATT Attribute Battery (UUID 0x180f)	btgatt.uuid0x180f
Bluetooth GATT Attribute Blood Pressure (UUID 0x1810)	btgatt.uuid0x1810
Bluetooth GATT Attribute Alert Notification (UUID 0x1811)	btgatt.uuid0x1811
Bluetooth GATT Attribute Human Interface Device (UUID 0x1812)	btgatt.uuid0x1812
Bluetooth GATT Attribute Scan Parameters (UUID 0x1813)	btgatt.uuid0x1813
Bluetooth GATT Attribute Running Speed and Cadence (UUID 0x1814)	btgatt.uuid0x1814
Bluetooth GATT Attribute Automation IO (UUID 0x1815)	btgatt.uuid0x1815
Bluetooth GATT Attribute Cycling Speed and Cadence (UUID 0x1816)	btgatt.uuid0x1816
Bluetooth GATT Attribute Cycling Power (UUID 0x1818)	btgatt.uuid0x1818
Bluetooth GATT Attribute Location and Navigation (UUID 0x1819)	btgatt.uuid0x1819
Bluetooth GATT Attribute Environmental Sensing (UUID 0x181a)	btgatt.uuid0x181a
Bluetooth GATT Attribute Body Composition (UUID 0x181b)	btgatt.uuid0x181b
Bluetooth GATT Attribute User Data (UUID 0x181c)	btgatt.uuid0x181c
Bluetooth GATT Attribute Weight Scale (UUID 0x181d)	btgatt.uuid0x181d
Bluetooth GATT Attribute Bond Management (UUID 0x181e)	btgatt.uuid0x181e
Bluetooth GATT Attribute Continuous Glucose Monitoring (UUID 0x181f)	btgatt.uuid0x181f
Bluetooth GATT Attribute Internet Protocol Support (UUID 0x1820)	btgatt.uuid0x1820
Bluetooth GATT Attribute Indoor Positioning (UUID 0x1821)	btgatt.uuid0x1821
Bluetooth GATT Attribute Pulse Oximeter (UUID 0x1822)	btgatt.uuid0x1822
Bluetooth GATT Attribute HTTP Proxy (UUID 0x1823)	btgatt.uuid0x1823
Bluetooth GATT Attribute Transport Discovery (UUID 0x1824)	btgatt.uuid0x1824
Bluetooth GATT Attribute Object Transfer (UUID 0x1825)	btgatt.uuid0x1825
Bluetooth GATT Attribute Fitness Machine (UUID 0x1826)	btgatt.uuid0x1826
Bluetooth GATT Attribute Mesh Provisioning (UUID 0x1827)	btgatt.uuid0x1827
Bluetooth GATT Attribute Mesh Proxy (UUID 0x1828)	btgatt.uuid0x1828
Bluetooth GATT Attribute Reconnection Configuration (UUID 0x1829)	btgatt.uuid0x1829
Bluetooth GATT Attribute Insulin Delivery (UUID 0x183a)	btgatt.uuid0x183a
Bluetooth GATT Attribute Binary Sensor (UUID 0x183b)	btgatt.uuid0x183b
Bluetooth GATT Attribute Emergency Configuration (UUID 0x183c)	btgatt.uuid0x183c
Bluetooth GATT Attribute Authorization Control (UUID 0x183d)	btgatt.uuid0x183d
Bluetooth GATT Attribute Physical Activity Monitor (UUID 0x183e)	btgatt.uuid0x183e
Bluetooth GATT Attribute Elapsed Time (UUID 0x183f)	btgatt.uuid0x183f
Bluetooth GATT Attribute Generic Health Sensor (UUID 0x1840)	btgatt.uuid0x1840
Bluetooth GATT Attribute Audio Input Control (UUID 0x1843)	btgatt.uuid0x1843
Bluetooth GATT Attribute Volume Control (UUID 0x1844)	btgatt.uuid0x1844
Bluetooth GATT Attribute Volume Offset Control (UUID 0x1845)	btgatt.uuid0x1845
Bluetooth GATT Attribute Coordinated Set Identification (UUID 0x1846)	btgatt.uuid0x1846
Bluetooth GATT Attribute Device Time (UUID 0x1847)	btgatt.uuid0x1847
Bluetooth GATT Attribute Media Control (UUID 0x1848)	btgatt.uuid0x1848
Bluetooth GATT Attribute Generic Media Control (UUID 0x1849)	btgatt.uuid0x1849
Bluetooth GATT Attribute Constant Tone Extension (UUID 0x184a)	btgatt.uuid0x184a
Bluetooth GATT Attribute Telephone Bearer (UUID 0x184b)	btgatt.uuid0x184b
Bluetooth GATT Attribute Generic Telephone Bearer (UUID 0x184c)	btgatt.uuid0x184c
Bluetooth GATT Attribute Microphone Control (UUID 0x184d)	btgatt.uuid0x184d
Bluetooth GATT Attribute Audio Stream Control (UUID 0x184e)	btgatt.uuid0x184e
Bluetooth GATT Attribute Broadcast Audio Scan (UUID 0x184f)	btgatt.uuid0x184f
Bluetooth GATT Attribute Published Audio Capabilities (UUID 0x1850)	btgatt.uuid0x1850
Bluetooth GATT Attribute Basic Audio Announcement (UUID 0x1851)	btgatt.uuid0x1851
Bluetooth GATT Attribute Broadcast Audio Announcement (UUID 0x1852)	btgatt.uuid0x1852
Bluetooth GATT Attribute Common Audio (UUID 0x1853)	btgatt.uuid0x1853
Bluetooth GATT Attribute Hearing Access (UUID 0x1854)	btgatt.uuid0x1854
Bluetooth GATT Attribute Telephony and Media Audio (UUID 0x1855)	btgatt.uuid0x1855
Bluetooth GATT Attribute Public Broadcast Announcement (UUID 0x1856)	btgatt.uuid0x1856
Bluetooth GATT Attribute Electronic Shelf Label (UUID 0x1857)	btgatt.uuid0x1857
Bluetooth GATT Attribute Gaming Audio (UUID 0x1858)	btgatt.uuid0x1858
Bluetooth GATT Attribute Mesh Proxy Solicitation (UUID 0x1859)	btgatt.uuid0x1859
Bluetooth GATT Attribute Primary Service (UUID 0x2800)	btgatt.uuid0x2800
Bluetooth GATT Attribute Secondary Service (UUID 0x2801)	btgatt.uuid0x2801
Bluetooth GATT Attribute Include (UUID 0x2802)	btgatt.uuid0x2802
Bluetooth GATT Attribute Characteristic (UUID 0x2803)	btgatt.uuid0x2803
Bluetooth GATT Attribute Characteristic Extended Properties (UUID 0x2900)	btgatt.uuid0x2900
Bluetooth GATT Attribute Characteristic User Description (UUID 0x2901)	btgatt.uuid0x2901
Bluetooth GATT Attribute Client Characteristic Configuration (UUID 0x2902)	btgatt.uuid0x2902
Bluetooth GATT Attribute Server Characteristic Configuration (UUID 0x2903)	btgatt.uuid0x2903
Bluetooth GATT Attribute Characteristic Presentation Format (UUID 0x2904)	btgatt.uuid0x2904
Bluetooth GATT Attribute Characteristic Aggregate Format (UUID 0x2905)	btgatt.uuid0x2905
Bluetooth GATT Attribute Valid Range (UUID 0x2906)	btgatt.uuid0x2906
Bluetooth GATT Attribute External Report Reference (UUID 0x2907)	btgatt.uuid0x2907
Bluetooth GATT Attribute Report Reference (UUID 0x2908)	btgatt.uuid0x2908
Bluetooth GATT Attribute Number of Digitals (UUID 0x2909)	btgatt.uuid0x2909
Bluetooth GATT Attribute Value Trigger Setting (UUID 0x290a)	btgatt.uuid0x290a
Bluetooth GATT Attribute Environmental Sensing Configuration (UUID 0x290b)	btgatt.uuid0x290b
Bluetooth GATT Attribute Environmental Sensing Measurement (UUID 0x290c)	btgatt.uuid0x290c
Bluetooth GATT Attribute Environmental Sensing Trigger Setting (UUID 0x290d)	btgatt.uuid0x290d
Bluetooth GATT Attribute Time Trigger Setting (UUID 0x290e)	btgatt.uuid0x290e
Bluetooth GATT Attribute Complete BR-EDR Transport Block Data (UUID 0x290f)	btgatt.uuid0x290f
Bluetooth GATT Attribute Observation Schedule (UUID 0x2910)	btgatt.uuid0x2910
Bluetooth GATT Attribute Valid Range and Accuracy (UUID 0x2911)	btgatt.uuid0x2911
Bluetooth GATT Attribute Device Name (UUID 0x2a00)	btgatt.uuid0x2a00
Bluetooth GATT Attribute Appearance (UUID 0x2a01)	btgatt.uuid0x2a01
Bluetooth GATT Attribute Peripheral Privacy Flag (UUID 0x2a02)	btgatt.uuid0x2a02
Bluetooth GATT Attribute Reconnection Address (UUID 0x2a03)	btgatt.uuid0x2a03
Bluetooth GATT Attribute Peripheral Preferred Connection Parameters (UUID 0x2a04)	btgatt.uuid0x2a04
Bluetooth GATT Attribute Service Changed (UUID 0x2a05)	btgatt.uuid0x2a05
Bluetooth GATT Attribute Alert Level (UUID 0x2a06)	btgatt.uuid0x2a06
Bluetooth GATT Attribute Tx Power Level (UUID 0x2a07)	btgatt.uuid0x2a07
Bluetooth GATT Attribute Date Time (UUID 0x2a08)	btgatt.uuid0x2a08
Bluetooth GATT Attribute Day of Week (UUID 0x2a09)	btgatt.uuid0x2a09
Bluetooth GATT Attribute Day Date Time (UUID 0x2a0a)	btgatt.uuid0x2a0a
Bluetooth GATT Attribute Exact Time 100 (UUID 0x2a0b)	btgatt.uuid0x2a0b
Bluetooth GATT Attribute Exact Time 256 (UUID 0x2a0c)	btgatt.uuid0x2a0c
Bluetooth GATT Attribute DST Offset (UUID 0x2a0d)	btgatt.uuid0x2a0d
Bluetooth GATT Attribute Time Zone (UUID 0x2a0e)	btgatt.uuid0x2a0e
Bluetooth GATT Attribute Local Time Information (UUID 0x2a0f)	btgatt.uuid0x2a0f
Bluetooth GATT Attribute Secondary Time Zone (UUID 0x2a10)	btgatt.uuid0x2a10
Bluetooth GATT Attribute Time with DST (UUID 0x2a11)	btgatt.uuid0x2a11
Bluetooth GATT Attribute Time Accuracy (UUID 0x2a12)	btgatt.uuid0x2a12
Bluetooth GATT Attribute Time Source (UUID 0x2a13)	btgatt.uuid0x2a13
Bluetooth GATT Attribute Reference Time Information (UUID 0x2a14)	btgatt.uuid0x2a14
Bluetooth GATT Attribute Time Broadcast (UUID 0x2a15)	btgatt.uuid0x2a15
Bluetooth GATT Attribute Time Update Control Point (UUID 0x2a16)	btgatt.uuid0x2a16
Bluetooth GATT Attribute Time Update State (UUID 0x2a17)	btgatt.uuid0x2a17
Bluetooth GATT Attribute Glucose Measurement (UUID 0x2a18)	btgatt.uuid0x2a18
Bluetooth GATT Attribute Battery Level (UUID 0x2a19)	btgatt.uuid0x2a19
Bluetooth GATT Attribute Battery Power State (UUID 0x2a1a)	btgatt.uuid0x2a1a
Bluetooth GATT Attribute Battery Level State (UUID 0x2a1b)	btgatt.uuid0x2a1b
Bluetooth GATT Attribute Temperature Measurement (UUID 0x2a1c)	btgatt.uuid0x2a1c
Bluetooth GATT Attribute Temperature Type (UUID 0x2a1d)	btgatt.uuid0x2a1d
Bluetooth GATT Attribute Intermediate Temperature (UUID 0x2a1e)	btgatt.uuid0x2a1e
Bluetooth GATT Attribute Temperature Celsius (UUID 0x2a1f)	btgatt.uuid0x2a1f
Bluetooth GATT Attribute Temperature Fahrenheit (UUID 0x2a20)	btgatt.uuid0x2a20
Bluetooth GATT Attribute Measurement Interval (UUID 0x2a21)	btgatt.uuid0x2a21
Bluetooth GATT Attribute Boot Keyboard Input Report (UUID 0x2a22)	btgatt.uuid0x2a22
Bluetooth GATT Attribute System ID (UUID 0x2a23)	btgatt.uuid0x2a23
Bluetooth GATT Attribute Model Number String (UUID 0x2a24)	btgatt.uuid0x2a24
Bluetooth GATT Attribute Serial Number String (UUID 0x2a25)	btgatt.uuid0x2a25
Bluetooth GATT Attribute Firmware Revision String (UUID 0x2a26)	btgatt.uuid0x2a26
Bluetooth GATT Attribute Hardware Revision String (UUID 0x2a27)	btgatt.uuid0x2a27
Bluetooth GATT Attribute Software Revision String (UUID 0x2a28)	btgatt.uuid0x2a28
Bluetooth GATT Attribute Manufacturer Name String (UUID 0x2a29)	btgatt.uuid0x2a29
Bluetooth GATT Attribute IEEE 11073-20601 Regulatory Certification Data List (UUID 0x2a2a)	btgatt.uuid0x2a2a
Bluetooth GATT Attribute Current Time (UUID 0x2a2b)	btgatt.uuid0x2a2b
Bluetooth GATT Attribute Magnetic Declination (UUID 0x2a2c)	btgatt.uuid0x2a2c
Bluetooth GATT Attribute Position 2D (UUID 0x2a2f)	btgatt.uuid0x2a2f
Bluetooth GATT Attribute Position 3D (UUID 0x2a30)	btgatt.uuid0x2a30
Bluetooth GATT Attribute Scan Refresh (UUID 0x2a31)	btgatt.uuid0x2a31
Bluetooth GATT Attribute Boot Keyboard Output Report (UUID 0x2a32)	btgatt.uuid0x2a32
Bluetooth GATT Attribute Boot Mouse Input Report (UUID 0x2a33)	btgatt.uuid0x2a33
Bluetooth GATT Attribute Glucose Measurement Context (UUID 0x2a34)	btgatt.uuid0x2a34
Bluetooth GATT Attribute Blood Pressure Measurement (UUID 0x2a35)	btgatt.uuid0x2a35
Bluetooth GATT Attribute Intermediate Cuff Pressure (UUID 0x2a36)	btgatt.uuid0x2a36
Bluetooth GATT Attribute Heart Rate Measurement (UUID 0x2a37)	btgatt.uuid0x2a37
Bluetooth GATT Attribute Body Sensor Location (UUID 0x2a38)	btgatt.uuid0x2a38
Bluetooth GATT Attribute Heart Rate Control Point (UUID 0x2a39)	btgatt.uuid0x2a39
Bluetooth GATT Attribute Removable (UUID 0x2a3a)	btgatt.uuid0x2a3a
Bluetooth GATT Attribute Service Required (UUID 0x2a3b)	btgatt.uuid0x2a3b
Bluetooth GATT Attribute Scientific Temperature Celsius (UUID 0x2a3c)	btgatt.uuid0x2a3c
Bluetooth GATT Attribute String (UUID 0x2a3d)	btgatt.uuid0x2a3d
Bluetooth GATT Attribute Network Availability (UUID 0x2a3e)	btgatt.uuid0x2a3e
Bluetooth GATT Attribute Alert Status (UUID 0x2a3f)	btgatt.uuid0x2a3f
Bluetooth GATT Attribute Ringer Control Point (UUID 0x2a40)	btgatt.uuid0x2a40
Bluetooth GATT Attribute Ringer Setting (UUID 0x2a41)	btgatt.uuid0x2a41
Bluetooth GATT Attribute Alert Category ID Bit Mask (UUID 0x2a42)	btgatt.uuid0x2a42
Bluetooth GATT Attribute Alert Category ID (UUID 0x2a43)	btgatt.uuid0x2a43
Bluetooth GATT Attribute Alert Notification Control Point (UUID 0x2a44)	btgatt.uuid0x2a44
Bluetooth GATT Attribute Unread Alert Status (UUID 0x2a45)	btgatt.uuid0x2a45
Bluetooth GATT Attribute New Alert (UUID 0x2a46)	btgatt.uuid0x2a46
Bluetooth GATT Attribute Supported New Alert Category (UUID 0x2a47)	btgatt.uuid0x2a47
Bluetooth GATT Attribute Supported Unread Alert Category (UUID 0x2a48)	btgatt.uuid0x2a48
Bluetooth GATT Attribute Blood Pressure Feature (UUID 0x2a49)	btgatt.uuid0x2a49
Bluetooth GATT Attribute HID Information (UUID 0x2a4a)	btgatt.uuid0x2a4a
Bluetooth GATT Attribute Report Map (UUID 0x2a4b)	btgatt.uuid0x2a4b
Bluetooth GATT Attribute HID Control Point (UUID 0x2a4c)	btgatt.uuid0x2a4c
Bluetooth GATT Attribute Report (UUID 0x2a4d)	btgatt.uuid0x2a4d
Bluetooth GATT Attribute Protocol Mode (UUID 0x2a4e)	btgatt.uuid0x2a4e
Bluetooth GATT Attribute Scan Interval Window (UUID 0x2a4f)	btgatt.uuid0x2a4f
Bluetooth GATT Attribute PnP ID (UUID 0x2a50)	btgatt.uuid0x2a50
Bluetooth GATT Attribute Glucose Feature (UUID 0x2a51)	btgatt.uuid0x2a51
Bluetooth GATT Attribute Record Access Control Point (UUID 0x2a52)	btgatt.uuid0x2a52
Bluetooth GATT Attribute RSC Measurement (UUID 0x2a53)	btgatt.uuid0x2a53
Bluetooth GATT Attribute RSC Feature (UUID 0x2a54)	btgatt.uuid0x2a54
Bluetooth GATT Attribute SC Control Point (UUID 0x2a55)	btgatt.uuid0x2a55
Bluetooth GATT Attribute Digital (UUID 0x2a56)	btgatt.uuid0x2a56
Bluetooth GATT Attribute Digital Output (UUID 0x2a57)	btgatt.uuid0x2a57
Bluetooth GATT Attribute Analog (UUID 0x2a58)	btgatt.uuid0x2a58
Bluetooth GATT Attribute Analog Output (UUID 0x2a59)	btgatt.uuid0x2a59
Bluetooth GATT Attribute Aggregate (UUID 0x2a5a)	btgatt.uuid0x2a5a
Bluetooth GATT Attribute CSC Measurement (UUID 0x2a5b)	btgatt.uuid0x2a5b
Bluetooth GATT Attribute CSC Feature (UUID 0x2a5c)	btgatt.uuid0x2a5c
Bluetooth GATT Attribute Sensor Location (UUID 0x2a5d)	btgatt.uuid0x2a5d
Bluetooth GATT Attribute PLX Spot-Check Measurement (UUID 0x2a5e)	btgatt.uuid0x2a5e
Bluetooth GATT Attribute PLX Continuous Measurement (UUID 0x2a5f)	btgatt.uuid0x2a5f
Bluetooth GATT Attribute PLX Features (UUID 0x2a60)	btgatt.uuid0x2a60
Bluetooth GATT Attribute Pulse Oximetry Control Point (UUID 0x2a62)	btgatt.uuid0x2a62
Bluetooth GATT Attribute Cycling Power Measurement (UUID 0x2a63)	btgatt.uuid0x2a63
Bluetooth GATT Attribute Cycling Power Vector (UUID 0x2a64)	btgatt.uuid0x2a64
Bluetooth GATT Attribute Cycling Power Feature (UUID 0x2a65)	btgatt.uuid0x2a65
Bluetooth GATT Attribute Cycling Power Control Point (UUID 0x2a66)	btgatt.uuid0x2a66
Bluetooth GATT Attribute Location and Speed (UUID 0x2a67)	btgatt.uuid0x2a67
Bluetooth GATT Attribute Navigation (UUID 0x2a68)	btgatt.uuid0x2a68
Bluetooth GATT Attribute Position Quality (UUID 0x2a69)	btgatt.uuid0x2a69
Bluetooth GATT Attribute LN Feature (UUID 0x2a6a)	btgatt.uuid0x2a6a
Bluetooth GATT Attribute LN Control Point (UUID 0x2a6b)	btgatt.uuid0x2a6b
Bluetooth GATT Attribute Elevation (UUID 0x2a6c)	btgatt.uuid0x2a6c
Bluetooth GATT Attribute Pressure (UUID 0x2a6d)	btgatt.uuid0x2a6d
Bluetooth GATT Attribute Temperature (UUID 0x2a6e)	btgatt.uuid0x2a6e
Bluetooth GATT Attribute Humidity (UUID 0x2a6f)	btgatt.uuid0x2a6f
Bluetooth GATT Attribute True Wind Speed (UUID 0x2a70)	btgatt.uuid0x2a70
Bluetooth GATT Attribute True Wind Direction (UUID 0x2a71)	btgatt.uuid0x2a71
Bluetooth GATT Attribute Apparent Wind Speed (UUID 0x2a72)	btgatt.uuid0x2a72
Bluetooth GATT Attribute Apparent Wind Direction (UUID 0x2a73)	btgatt.uuid0x2a73
Bluetooth GATT Attribute Gust Factor (UUID 0x2a74)	btgatt.uuid0x2a74
Bluetooth GATT Attribute Pollen Concentration (UUID 0x2a75)	btgatt.uuid0x2a75
Bluetooth GATT Attribute UV Index (UUID 0x2a76)	btgatt.uuid0x2a76
Bluetooth GATT Attribute Irradiance (UUID 0x2a77)	btgatt.uuid0x2a77
Bluetooth GATT Attribute Rainfall (UUID 0x2a78)	btgatt.uuid0x2a78
Bluetooth GATT Attribute Wind Chill (UUID 0x2a79)	btgatt.uuid0x2a79
Bluetooth GATT Attribute Heat Index (UUID 0x2a7a)	btgatt.uuid0x2a7a
Bluetooth GATT Attribute Dew Point (UUID 0x2a7b)	btgatt.uuid0x2a7b
Bluetooth GATT Attribute Descriptor Value Changed (UUID 0x2a7d)	btgatt.uuid0x2a7d
Bluetooth GATT Attribute Aerobic Heart Rate Lower Limit (UUID 0x2a7e)	btgatt.uuid0x2a7e
Bluetooth GATT Attribute Aerobic Threshold (UUID 0x2a7f)	btgatt.uuid0x2a7f
Bluetooth GATT Attribute Age (UUID 0x2a80)	btgatt.uuid0x2a80
Bluetooth GATT Attribute Anaerobic Heart Rate Lower Limit (UUID 0x2a81)	btgatt.uuid0x2a81
Bluetooth GATT Attribute Anaerobic Heart Rate Upper Limit (UUID 0x2a82)	btgatt.uuid0x2a82
Bluetooth GATT Attribute Anaerobic Threshold (UUID 0x2a83)	btgatt.uuid0x2a83
Bluetooth GATT Attribute Aerobic Heart Rate Upper Limit (UUID 0x2a84)	btgatt.uuid0x2a84
Bluetooth GATT Attribute Date of Birth (UUID 0x2a85)	btgatt.uuid0x2a85
Bluetooth GATT Attribute Date of Threshold Assessment (UUID 0x2a86)	btgatt.uuid0x2a86
Bluetooth GATT Attribute Email Address (UUID 0x2a87)	btgatt.uuid0x2a87
Bluetooth GATT Attribute Fat Burn Heart Rate Lower Limit (UUID 0x2a88)	btgatt.uuid0x2a88
Bluetooth GATT Attribute Fat Burn Heart Rate Upper Limit (UUID 0x2a89)	btgatt.uuid0x2a89
Bluetooth GATT Attribute First Name (UUID 0x2a8a)	btgatt.uuid0x2a8a
Bluetooth GATT Attribute Five Zone Heart Rate Limits (UUID 0x2a8b)	btgatt.uuid0x2a8b
Bluetooth GATT Attribute Gender (UUID 0x2a8c)	btgatt.uuid0x2a8c
Bluetooth GATT Attribute Heart Rate Max (UUID 0x2a8d)	btgatt.uuid0x2a8d
Bluetooth GATT Attribute Height (UUID 0x2a8e)	btgatt.uuid0x2a8e
Bluetooth GATT Attribute Hip Circumference (UUID 0x2a8f)	btgatt.uuid0x2a8f
Bluetooth GATT Attribute Last Name (UUID 0x2a90)	btgatt.uuid0x2a90
Bluetooth GATT Attribute Maximum Recommended Heart Rate (UUID 0x2a91)	btgatt.uuid0x2a91
Bluetooth GATT Attribute Resting Heart Rate (UUID 0x2a92)	btgatt.uuid0x2a92
Bluetooth GATT Attribute Sport Type for Aerobic and Anaerobic Thresholds (UUID 0x2a93)	btgatt.uuid0x2a93
Bluetooth GATT Attribute Three Zone Heart Rate Limits (UUID 0x2a94)	btgatt.uuid0x2a94
Bluetooth GATT Attribute Two Zone Heart Rate Limits (UUID 0x2a95)	btgatt.uuid0x2a95
Bluetooth GATT Attribute VO2 Max (UUID 0x2a96)	btgatt.uuid0x2a96
Bluetooth GATT Attribute Waist Circumference (UUID 0x2a97)	btgatt.uuid0x2a97
Bluetooth GATT Attribute Weight (UUID 0x2a98)	btgatt.uuid0x2a98
Bluetooth GATT Attribute Database Change Increment (UUID 0x2a99)	btgatt.uuid0x2a99
Bluetooth GATT Attribute User Index (UUID 0x2a9a)	btgatt.uuid0x2a9a
Bluetooth GATT Attribute Body Composition Feature (UUID 0x2a9b)	btgatt.uuid0x2a9b
Bluetooth GATT Attribute Body Composition Measurement (UUID 0x2a9c)	btgatt.uuid0x2a9c
Bluetooth GATT Attribute Weight Measurement (UUID 0x2a9d)	btgatt.uuid0x2a9d
Bluetooth GATT Attribute Weight Scale Feature (UUID 0x2a9e)	btgatt.uuid0x2a9e
Bluetooth GATT Attribute User Control Point (UUID 0x2a9f)	btgatt.uuid0x2a9f
Bluetooth GATT Attribute Magnetic Flux Density - 2D (UUID 0x2aa0)	btgatt.uuid0x2aa0
Bluetooth GATT Attribute Magnetic Flux Density - 3D (UUID 0x2aa1)	btgatt.uuid0x2aa1
Bluetooth GATT Attribute Language (UUID 0x2aa2)	btgatt.uuid0x2aa2
Bluetooth GATT Attribute Barometric Pressure Trend (UUID 0x2aa3)	btgatt.uuid0x2aa3
Bluetooth GATT Attribute Bond Management Control Point (UUID 0x2aa4)	btgatt.uuid0x2aa4
Bluetooth GATT Attribute Bond Management Feature (UUID 0x2aa5)	btgatt.uuid0x2aa5
Bluetooth GATT Attribute Central Address Resolution (UUID 0x2aa6)	btgatt.uuid0x2aa6
Bluetooth GATT Attribute CGM Measurement (UUID 0x2aa7)	btgatt.uuid0x2aa7
Bluetooth GATT Attribute CGM Feature (UUID 0x2aa8)	btgatt.uuid0x2aa8
Bluetooth GATT Attribute CGM Status (UUID 0x2aa9)	btgatt.uuid0x2aa9
Bluetooth GATT Attribute CGM Session Start Time (UUID 0x2aaa)	btgatt.uuid0x2aaa
Bluetooth GATT Attribute CGM Session Run Time (UUID 0x2aab)	btgatt.uuid0x2aab
Bluetooth GATT Attribute CGM Specific Ops Control Point (UUID 0x2aac)	btgatt.uuid0x2aac
Bluetooth GATT Attribute Indoor Positioning Configuration (UUID 0x2aad)	btgatt.uuid0x2aad
Bluetooth GATT Attribute Latitude (UUID 0x2aae)	btgatt.uuid0x2aae
Bluetooth GATT Attribute Longitude (UUID 0x2aaf)	btgatt.uuid0x2aaf
Bluetooth GATT Attribute Local North Coordinate (UUID 0x2ab0)	btgatt.uuid0x2ab0
Bluetooth GATT Attribute Local East Coordinate (UUID 0x2ab1)	btgatt.uuid0x2ab1
Bluetooth GATT Attribute Floor Number (UUID 0x2ab2)	btgatt.uuid0x2ab2
Bluetooth GATT Attribute Altitude (UUID 0x2ab3)	btgatt.uuid0x2ab3
Bluetooth GATT Attribute Uncertainty (UUID 0x2ab4)	btgatt.uuid0x2ab4
Bluetooth GATT Attribute Location Name (UUID 0x2ab5)	btgatt.uuid0x2ab5
Bluetooth GATT Attribute URI (UUID 0x2ab6)	btgatt.uuid0x2ab6
Bluetooth GATT Attribute HTTP Headers (UUID 0x2ab7)	btgatt.uuid0x2ab7
Bluetooth GATT Attribute HTTP Status Code (UUID 0x2ab8)	btgatt.uuid0x2ab8
Bluetooth GATT Attribute HTTP Entity Body (UUID 0x2ab9)	btgatt.uuid0x2ab9
Bluetooth GATT Attribute HTTP Control Point (UUID 0x2aba)	btgatt.uuid0x2aba
Bluetooth GATT Attribute HTTPS Security (UUID 0x2abb)	btgatt.uuid0x2abb
Bluetooth GATT Attribute TDS Control Point (UUID 0x2abc)	btgatt.uuid0x2abc
Bluetooth GATT Attribute OTS Feature (UUID 0x2abd)	btgatt.uuid0x2abd
Bluetooth GATT Attribute Object Name (UUID 0x2abe)	btgatt.uuid0x2abe
Bluetooth GATT Attribute Object Type (UUID 0x2abf)	btgatt.uuid0x2abf
Bluetooth GATT Attribute Object Size (UUID 0x2ac0)	btgatt.uuid0x2ac0
Bluetooth GATT Attribute Object First-Created (UUID 0x2ac1)	btgatt.uuid0x2ac1
Bluetooth GATT Attribute Object Last-Modified (UUID 0x2ac2)	btgatt.uuid0x2ac2
Bluetooth GATT Attribute Object ID (UUID 0x2ac3)	btgatt.uuid0x2ac3
Bluetooth GATT Attribute Object Properties (UUID 0x2ac4)	btgatt.uuid0x2ac4
Bluetooth GATT Attribute Object Action Control Point (UUID 0x2ac5)	btgatt.uuid0x2ac5
Bluetooth GATT Attribute Object List Control Point (UUID 0x2ac6)	btgatt.uuid0x2ac6
Bluetooth GATT Attribute Object List Filter (UUID 0x2ac7)	btgatt.uuid0x2ac7
Bluetooth GATT Attribute Object Changed (UUID 0x2ac8)	btgatt.uuid0x2ac8
Bluetooth GATT Attribute Resolvable Private Address Only (UUID 0x2ac9)	btgatt.uuid0x2ac9
Bluetooth GATT Attribute Unspecified (UUID 0x2aca)	btgatt.uuid0x2aca
Bluetooth GATT Attribute Directory Listing (UUID 0x2acb)	btgatt.uuid0x2acb
Bluetooth GATT Attribute Fitness Machine Feature (UUID 0x2acc)	btgatt.uuid0x2acc
Bluetooth GATT Attribute Treadmill Data (UUID 0x2acd)	btgatt.uuid0x2acd
Bluetooth GATT Attribute Cross Trainer Data (UUID 0x2ace)	btgatt.uuid0x2ace
Bluetooth GATT Attribute Step Climber Data (UUID 0x2acf)	btgatt.uuid0x2acf
Bluetooth GATT Attribute Stair Climber Data (UUID 0x2ad0)	btgatt.uuid0x2ad0
Bluetooth GATT Attribute Rower Data (UUID 0x2ad1)	btgatt.uuid0x2ad1
Bluetooth GATT Attribute Indoor Bike Data (UUID 0x2ad2)	btgatt.uuid0x2ad2
Bluetooth GATT Attribute Training Status (UUID 0x2ad3)	btgatt.uuid0x2ad3
Bluetooth GATT Attribute Supported Speed Range (UUID 0x2ad4)	btgatt.uuid0x2ad4
Bluetooth GATT Attribute Supported Inclination Range (UUID 0x2ad5)	btgatt.uuid0x2ad5
Bluetooth GATT Attribute Supported Resistance Level Range (UUID 0x2ad6)	btgatt.uuid0x2ad6
Bluetooth GATT Attribute Supported Heart Rate Range (UUID 0x2ad7)	btgatt.uuid0x2ad7
Bluetooth GATT Attribute Supported Power Range (UUID 0x2ad8)	btgatt.uuid0x2ad8
Bluetooth GATT Attribute Fitness Machine Control Point (UUID 0x2ad9)	btgatt.uuid0x2ad9
Bluetooth GATT Attribute Fitness Machine Status (UUID 0x2ada)	btgatt.uuid0x2ada
Bluetooth GATT Attribute Mesh Provisioning Data In (UUID 0x2adb)	btgatt.uuid0x2adb
Bluetooth GATT Attribute Mesh Provisioning Data Out (UUID 0x2adc)	btgatt.uuid0x2adc
Bluetooth GATT Attribute Mesh Proxy Data In (UUID 0x2add)	btgatt.uuid0x2add
Bluetooth GATT Attribute Mesh Proxy Data Out (UUID 0x2ade)	btgatt.uuid0x2ade
Bluetooth GATT Attribute Average Current (UUID 0x2ae0)	btgatt.uuid0x2ae0
Bluetooth GATT Attribute Average Voltage (UUID 0x2ae1)	btgatt.uuid0x2ae1
Bluetooth GATT Attribute Boolean (UUID 0x2ae2)	btgatt.uuid0x2ae2
Bluetooth GATT Attribute Chromatic Distance from Planckian (UUID 0x2ae3)	btgatt.uuid0x2ae3
Bluetooth GATT Attribute Chromaticity Coordinates (UUID 0x2ae4)	btgatt.uuid0x2ae4
Bluetooth GATT Attribute Chromaticity in CCT and Duv Values (UUID 0x2ae5)	btgatt.uuid0x2ae5
Bluetooth GATT Attribute Chromaticity Tolerance (UUID 0x2ae6)	btgatt.uuid0x2ae6
Bluetooth GATT Attribute CIE 13.3-1995 Color Rendering Index (UUID 0x2ae7)	btgatt.uuid0x2ae7
Bluetooth GATT Attribute Coefficient (UUID 0x2ae8)	btgatt.uuid0x2ae8
Bluetooth GATT Attribute Correlated Color Temperature (UUID 0x2ae9)	btgatt.uuid0x2ae9
Bluetooth GATT Attribute Count 16 (UUID 0x2aea)	btgatt.uuid0x2aea
Bluetooth GATT Attribute Count 24 (UUID 0x2aeb)	btgatt.uuid0x2aeb
Bluetooth GATT Attribute Country Code (UUID 0x2aec)	btgatt.uuid0x2aec
Bluetooth GATT Attribute Date UTC (UUID 0x2aed)	btgatt.uuid0x2aed
Bluetooth GATT Attribute Electric Current (UUID 0x2aee)	btgatt.uuid0x2aee
Bluetooth GATT Attribute Electric Current Range (UUID 0x2aef)	btgatt.uuid0x2aef
Bluetooth GATT Attribute Electric Current Specification (UUID 0x2af0)	btgatt.uuid0x2af0
Bluetooth GATT Attribute Electric Current Statistics (UUID 0x2af1)	btgatt.uuid0x2af1
Bluetooth GATT Attribute Energy (UUID 0x2af2)	btgatt.uuid0x2af2
Bluetooth GATT Attribute Energy in a Period of Day (UUID 0x2af3)	btgatt.uuid0x2af3
Bluetooth GATT Attribute Event Statistics (UUID 0x2af4)	btgatt.uuid0x2af4
Bluetooth GATT Attribute Fixed String 16 (UUID 0x2af5)	btgatt.uuid0x2af5
Bluetooth GATT Attribute Fixed String 24 (UUID 0x2af6)	btgatt.uuid0x2af6
Bluetooth GATT Attribute Fixed String 36 (UUID 0x2af7)	btgatt.uuid0x2af7
Bluetooth GATT Attribute Fixed String 8 (UUID 0x2af8)	btgatt.uuid0x2af8
Bluetooth GATT Attribute Generic Level (UUID 0x2af9)	btgatt.uuid0x2af9
Bluetooth GATT Attribute Global Trade Item Number (UUID 0x2afa)	btgatt.uuid0x2afa
Bluetooth GATT Attribute Illuminance (UUID 0x2afb)	btgatt.uuid0x2afb
Bluetooth GATT Attribute Luminous Efficacy (UUID 0x2afc)	btgatt.uuid0x2afc
Bluetooth GATT Attribute Luminous Energy (UUID 0x2afd)	btgatt.uuid0x2afd
Bluetooth GATT Attribute Luminous Exposure (UUID 0x2afe)	btgatt.uuid0x2afe
Bluetooth GATT Attribute Luminous Flux (UUID 0x2aff)	btgatt.uuid0x2aff
Bluetooth GATT Attribute Luminous Flux Range (UUID 0x2b00)	btgatt.uuid0x2b00
Bluetooth GATT Attribute Luminous Intensity (UUID 0x2b01)	btgatt.uuid0x2b01
Bluetooth GATT Attribute Mass Flow (UUID 0x2b02)	btgatt.uuid0x2b02
Bluetooth GATT Attribute Perceived Lightness (UUID 0x2b03)	btgatt.uuid0x2b03
Bluetooth GATT Attribute Percentage 8 (UUID 0x2b04)	btgatt.uuid0x2b04
Bluetooth GATT Attribute Power (UUID 0x2b05)	btgatt.uuid0x2b05
Bluetooth GATT Attribute Power Specification (UUID 0x2b06)	btgatt.uuid0x2b06
Bluetooth GATT Attribute Relative Runtime in a Current Range (UUID 0x2b07)	btgatt.uuid0x2b07
Bluetooth GATT Attribute Relative Runtime in a Generic Level Range (UUID 0x2b08)	btgatt.uuid0x2b08
Bluetooth GATT Attribute Relative Value in a Voltage Range (UUID 0x2b09)	btgatt.uuid0x2b09
Bluetooth GATT Attribute Relative Value in an Illuminance Range (UUID 0x2b0a)	btgatt.uuid0x2b0a
Bluetooth GATT Attribute Relative Value in a Period of Day (UUID 0x2b0b)	btgatt.uuid0x2b0b
Bluetooth GATT Attribute Relative Value in a Temperature Range (UUID 0x2b0c)	btgatt.uuid0x2b0c
Bluetooth GATT Attribute Temperature 8 (UUID 0x2b0d)	btgatt.uuid0x2b0d
Bluetooth GATT Attribute Temperature 8 in a Period of Day (UUID 0x2b0e)	btgatt.uuid0x2b0e
Bluetooth GATT Attribute Temperature 8 Statistics (UUID 0x2b0f)	btgatt.uuid0x2b0f
Bluetooth GATT Attribute Temperature Range (UUID 0x2b10)	btgatt.uuid0x2b10
Bluetooth GATT Attribute Temperature Statistics (UUID 0x2b11)	btgatt.uuid0x2b11
Bluetooth GATT Attribute Time Decihour 8 (UUID 0x2b12)	btgatt.uuid0x2b12
Bluetooth GATT Attribute Time Exponential 8 (UUID 0x2b13)	btgatt.uuid0x2b13
Bluetooth GATT Attribute Time Hour 24 (UUID 0x2b14)	btgatt.uuid0x2b14
Bluetooth GATT Attribute Time Millisecond 24 (UUID 0x2b15)	btgatt.uuid0x2b15
Bluetooth GATT Attribute Time Second 16 (UUID 0x2b16)	btgatt.uuid0x2b16
Bluetooth GATT Attribute Time Second 8 (UUID 0x2b17)	btgatt.uuid0x2b17
Bluetooth GATT Attribute Voltage (UUID 0x2b18)	btgatt.uuid0x2b18
Bluetooth GATT Attribute Voltage Specification (UUID 0x2b19)	btgatt.uuid0x2b19
Bluetooth GATT Attribute Voltage Statistics (UUID 0x2b1a)	btgatt.uuid0x2b1a
Bluetooth GATT Attribute Volume Flow (UUID 0x2b1b)	btgatt.uuid0x2b1b
Bluetooth GATT Attribute Chromaticity Coordinate (UUID 0x2b1c)	btgatt.uuid0x2b1c
Bluetooth GATT Attribute RC Feature (UUID 0x2b1d)	btgatt.uuid0x2b1d
Bluetooth GATT Attribute RC Settings (UUID 0x2b1e)	btgatt.uuid0x2b1e
Bluetooth GATT Attribute Reconnection Configuration Control Point (UUID 0x2b1f)	btgatt.uuid0x2b1f
Bluetooth GATT Attribute IDD Status Changed (UUID 0x2b20)	btgatt.uuid0x2b20
Bluetooth GATT Attribute IDD Status (UUID 0x2b21)	btgatt.uuid0x2b21
Bluetooth GATT Attribute IDD Annunciation Status (UUID 0x2b22)	btgatt.uuid0x2b22
Bluetooth GATT Attribute IDD Features (UUID 0x2b23)	btgatt.uuid0x2b23
Bluetooth GATT Attribute IDD Status Reader Control Point (UUID 0x2b24)	btgatt.uuid0x2b24
Bluetooth GATT Attribute IDD Command Control Point (UUID 0x2b25)	btgatt.uuid0x2b25
Bluetooth GATT Attribute IDD Command Data (UUID 0x2b26)	btgatt.uuid0x2b26
Bluetooth GATT Attribute IDD Record Access Control Point (UUID 0x2b27)	btgatt.uuid0x2b27
Bluetooth GATT Attribute IDD History Data (UUID 0x2b28)	btgatt.uuid0x2b28
Bluetooth GATT Attribute Client Supported Features (UUID 0x2b29)	btgatt.uuid0x2b29
Bluetooth GATT Attribute Database Hash (UUID 0x2b2a)	btgatt.uuid0x2b2a
Bluetooth GATT Attribute BSS Control Point (UUID 0x2b2b)	btgatt.uuid0x2b2b
Bluetooth GATT Attribute BSS Response (UUID 0x2b2c)	btgatt.uuid0x2b2c
Bluetooth GATT Attribute Emergency ID (UUID 0x2b2d)	btgatt.uuid0x2b2d
Bluetooth GATT Attribute Emergency Text (UUID 0x2b2e)	btgatt.uuid0x2b2e
Bluetooth GATT Attribute ACS Status (UUID 0x2b2f)	btgatt.uuid0x2b2f
Bluetooth GATT Attribute ACS Data In (UUID 0x2b30)	btgatt.uuid0x2b30
Bluetooth GATT Attribute ACS Data Out Notify (UUID 0x2b31)	btgatt.uuid0x2b31
Bluetooth GATT Attribute ACS Data Out Indicate (UUID 0x2b32)	btgatt.uuid0x2b32
Bluetooth GATT Attribute ACS Control Point (UUID 0x2b33)	btgatt.uuid0x2b33
Bluetooth GATT Attribute Enhanced Blood Pressure Measurement (UUID 0x2b34)	btgatt.uuid0x2b34
Bluetooth GATT Attribute Enhanced Intermediate Cuff Pressure (UUID 0x2b35)	btgatt.uuid0x2b35
Bluetooth GATT Attribute Blood Pressure Record (UUID 0x2b36)	btgatt.uuid0x2b36
Bluetooth GATT Attribute Registered User (UUID 0x2b37)	btgatt.uuid0x2b37
Bluetooth GATT Attribute BR-EDR Handover Data (UUID 0x2b38)	btgatt.uuid0x2b38
Bluetooth GATT Attribute Bluetooth SIG Data (UUID 0x2b39)	btgatt.uuid0x2b39
Bluetooth GATT Attribute Server Supported Features (UUID 0x2b3a)	btgatt.uuid0x2b3a
Bluetooth GATT Attribute Physical Activity Monitor Features (UUID 0x2b3b)	btgatt.uuid0x2b3b
Bluetooth GATT Attribute General Activity Instantaneous Data (UUID 0x2b3c)	btgatt.uuid0x2b3c
Bluetooth GATT Attribute General Activity Summary Data (UUID 0x2b3d)	btgatt.uuid0x2b3d
Bluetooth GATT Attribute CardioRespiratory Activity Instantaneous Data (UUID 0x2b3e)	btgatt.uuid0x2b3e
Bluetooth GATT Attribute CardioRespiratory Activity Summary Data (UUID 0x2b3f)	btgatt.uuid0x2b3f
Bluetooth GATT Attribute Step Counter Activity Summary Data (UUID 0x2b40)	btgatt.uuid0x2b40
Bluetooth GATT Attribute Sleep Activity Instantaneous Data (UUID 0x2b41)	btgatt.uuid0x2b41
Bluetooth GATT Attribute Sleep Activity Summary Data (UUID 0x2b42)	btgatt.uuid0x2b42
Bluetooth GATT Attribute Physical Activity Monitor Control Point (UUID 0x2b43)	btgatt.uuid0x2b43
Bluetooth GATT Attribute Physical Activity Current Session (UUID 0x2b44)	btgatt.uuid0x2b44
Bluetooth GATT Attribute Physical Activity Session Descriptor (UUID 0x2b45)	btgatt.uuid0x2b45
Bluetooth GATT Attribute Preferred Units (UUID 0x2b46)	btgatt.uuid0x2b46
Bluetooth GATT Attribute High Resolution Height (UUID 0x2b47)	btgatt.uuid0x2b47
Bluetooth GATT Attribute Middle Name (UUID 0x2b48)	btgatt.uuid0x2b48
Bluetooth GATT Attribute Stride Length (UUID 0x2b49)	btgatt.uuid0x2b49
Bluetooth GATT Attribute Handedness (UUID 0x2b4a)	btgatt.uuid0x2b4a
Bluetooth GATT Attribute Device Wearing Position (UUID 0x2b4b)	btgatt.uuid0x2b4b
Bluetooth GATT Attribute Four Zone Heart Rate Limits (UUID 0x2b4c)	btgatt.uuid0x2b4c
Bluetooth GATT Attribute High Intensity Exercise Threshold (UUID 0x2b4d)	btgatt.uuid0x2b4d
Bluetooth GATT Attribute Activity Goal (UUID 0x2b4e)	btgatt.uuid0x2b4e
Bluetooth GATT Attribute Sedentary Interval Notification (UUID 0x2b4f)	btgatt.uuid0x2b4f
Bluetooth GATT Attribute Caloric Intake (UUID 0x2b50)	btgatt.uuid0x2b50
Bluetooth GATT Attribute TMAP Role (UUID 0x2b51)	btgatt.uuid0x2b51
Bluetooth GATT Attribute Audio Input State (UUID 0x2b77)	btgatt.uuid0x2b77
Bluetooth GATT Attribute Gain Settings Attribute (UUID 0x2b78)	btgatt.uuid0x2b78
Bluetooth GATT Attribute Audio Input Type (UUID 0x2b79)	btgatt.uuid0x2b79
Bluetooth GATT Attribute Audio Input Status (UUID 0x2b7a)	btgatt.uuid0x2b7a
Bluetooth GATT Attribute Audio Input Control Point (UUID 0x2b7b)	btgatt.uuid0x2b7b
Bluetooth GATT Attribute Audio Input Description (UUID 0x2b7c)	btgatt.uuid0x2b7c
Bluetooth GATT Attribute Volume State (UUID 0x2b7d)	btgatt.uuid0x2b7d
Bluetooth GATT Attribute Volume Control Point (UUID 0x2b7e)	btgatt.uuid0x2b7e
Bluetooth GATT Attribute Volume Flags (UUID 0x2b7f)	btgatt.uuid0x2b7f
Bluetooth GATT Attribute Volume Offset State (UUID 0x2b80)	btgatt.uuid0x2b80
Bluetooth GATT Attribute Audio Location (UUID 0x2b81)	btgatt.uuid0x2b81
Bluetooth GATT Attribute Volume Offset Control Point (UUID 0x2b82)	btgatt.uuid0x2b82
Bluetooth GATT Attribute Audio Output Description (UUID 0x2b83)	btgatt.uuid0x2b83
Bluetooth GATT Attribute Set Identity Resolving Key (UUID 0x2b84)	btgatt.uuid0x2b84
Bluetooth GATT Attribute Coordinated Set Size (UUID 0x2b85)	btgatt.uuid0x2b85
Bluetooth GATT Attribute Set Member Lock (UUID 0x2b86)	btgatt.uuid0x2b86
Bluetooth GATT Attribute Set Member Rank (UUID 0x2b87)	btgatt.uuid0x2b87
Bluetooth GATT Attribute Encrypted Data Key Material (UUID 0x2b88)	btgatt.uuid0x2b88
Bluetooth GATT Attribute Apparent Energy 32 (UUID 0x2b89)	btgatt.uuid0x2b89
Bluetooth GATT Attribute Apparent Power (UUID 0x2b8a)	btgatt.uuid0x2b8a
Bluetooth GATT Attribute Live Health Observations (UUID 0x2b8b)	btgatt.uuid0x2b8b
Bluetooth GATT Attribute CO Concentration (UUID 0x2b8c)	btgatt.uuid0x2b8c
Bluetooth GATT Attribute Cosine of the Angle (UUID 0x2b8d)	btgatt.uuid0x2b8d
Bluetooth GATT Attribute Device Time Feature (UUID 0x2b8e)	btgatt.uuid0x2b8e
Bluetooth GATT Attribute Device Time Parameters (UUID 0x2b8f)	btgatt.uuid0x2b8f
Bluetooth GATT Attribute Device Time (UUID 0x2b90)	btgatt.uuid0x2b90
Bluetooth GATT Attribute Device Time Control Point (UUID 0x2b91)	btgatt.uuid0x2b91
Bluetooth GATT Attribute Time Change Log Data (UUID 0x2b92)	btgatt.uuid0x2b92
Bluetooth GATT Attribute Media Player Name (UUID 0x2b93)	btgatt.uuid0x2b93
Bluetooth GATT Attribute Media Player Icon Object ID (UUID 0x2b94)	btgatt.uuid0x2b94
Bluetooth GATT Attribute Media Player Icon URL (UUID 0x2b95)	btgatt.uuid0x2b95
Bluetooth GATT Attribute Track Changed (UUID 0x2b96)	btgatt.uuid0x2b96
Bluetooth GATT Attribute Track Title (UUID 0x2b97)	btgatt.uuid0x2b97
Bluetooth GATT Attribute Track Duration (UUID 0x2b98)	btgatt.uuid0x2b98
Bluetooth GATT Attribute Track Position (UUID 0x2b99)	btgatt.uuid0x2b99
Bluetooth GATT Attribute Playback Speed (UUID 0x2b9a)	btgatt.uuid0x2b9a
Bluetooth GATT Attribute Seeking Speed (UUID 0x2b9b)	btgatt.uuid0x2b9b
Bluetooth GATT Attribute Current Track Segments Object ID (UUID 0x2b9c)	btgatt.uuid0x2b9c
Bluetooth GATT Attribute Current Track Object ID (UUID 0x2b9d)	btgatt.uuid0x2b9d
Bluetooth GATT Attribute Next Track Object ID (UUID 0x2b9e)	btgatt.uuid0x2b9e
Bluetooth GATT Attribute Parent Group Object ID (UUID 0x2b9f)	btgatt.uuid0x2b9f
Bluetooth GATT Attribute Current Group Object ID (UUID 0x2ba0)	btgatt.uuid0x2ba0
Bluetooth GATT Attribute Playing Order (UUID 0x2ba1)	btgatt.uuid0x2ba1
Bluetooth GATT Attribute Playing Orders Supported (UUID 0x2ba2)	btgatt.uuid0x2ba2
Bluetooth GATT Attribute Media State (UUID 0x2ba3)	btgatt.uuid0x2ba3
Bluetooth GATT Attribute Media Control Point (UUID 0x2ba4)	btgatt.uuid0x2ba4
Bluetooth GATT Attribute Media Control Point Opcodes Supported (UUID 0x2ba5)	btgatt.uuid0x2ba5
Bluetooth GATT Attribute Search Results Object ID (UUID 0x2ba6)	btgatt.uuid0x2ba6
Bluetooth GATT Attribute Search Control Point (UUID 0x2ba7)	btgatt.uuid0x2ba7
Bluetooth GATT Attribute Energy 32 (UUID 0x2ba8)	btgatt.uuid0x2ba8
Bluetooth GATT Attribute Media Player Icon Object Type (UUID 0x2ba9)	btgatt.uuid0x2ba9
Bluetooth GATT Attribute Track Segments Object Type (UUID 0x2baa)	btgatt.uuid0x2baa
Bluetooth GATT Attribute Track Object Type (UUID 0x2bab)	btgatt.uuid0x2bab
Bluetooth GATT Attribute Group Object Type (UUID 0x2bac)	btgatt.uuid0x2bac
Bluetooth GATT Attribute Constant Tone Extension Enable (UUID 0x2bad)	btgatt.uuid0x2bad
Bluetooth GATT Attribute Advertising Constant Tone Extension Minimum Length (UUID 0x2bae)	btgatt.uuid0x2bae
Bluetooth GATT Attribute Advertising Constant Tone Extension Minimum Transmit Count (UUID 0x2baf)	btgatt.uuid0x2baf
Bluetooth GATT Attribute Advertising Constant Tone Extension Transmit Duration (UUID 0x2bb0)	btgatt.uuid0x2bb0
Bluetooth GATT Attribute Advertising Constant Tone Extension Interval (UUID 0x2bb1)	btgatt.uuid0x2bb1
Bluetooth GATT Attribute Advertising Constant Tone Extension PHY (UUID 0x2bb2)	btgatt.uuid0x2bb2
Bluetooth GATT Attribute Bearer Provider Name (UUID 0x2bb3)	btgatt.uuid0x2bb3
Bluetooth GATT Attribute Bearer UCI (UUID 0x2bb4)	btgatt.uuid0x2bb4
Bluetooth GATT Attribute Bearer Technology (UUID 0x2bb5)	btgatt.uuid0x2bb5
Bluetooth GATT Attribute Bearer URI Schemes Supported List (UUID 0x2bb6)	btgatt.uuid0x2bb6
Bluetooth GATT Attribute Bearer Signal Strength (UUID 0x2bb7)	btgatt.uuid0x2bb7
Bluetooth GATT Attribute Bearer Signal Strength Reporting Interval (UUID 0x2bb8)	btgatt.uuid0x2bb8
Bluetooth GATT Attribute Bearer List Current Calls (UUID 0x2bb9)	btgatt.uuid0x2bb9
Bluetooth GATT Attribute Content Control ID (UUID 0x2bba)	btgatt.uuid0x2bba
Bluetooth GATT Attribute Status Flags (UUID 0x2bbb)	btgatt.uuid0x2bbb
Bluetooth GATT Attribute Incoming Call Target Bearer URI (UUID 0x2bbc)	btgatt.uuid0x2bbc
Bluetooth GATT Attribute Call State (UUID 0x2bbd)	btgatt.uuid0x2bbd
Bluetooth GATT Attribute Call Control Point (UUID 0x2bbe)	btgatt.uuid0x2bbe
Bluetooth GATT Attribute Call Control Point Optional Opcodes (UUID 0x2bbf)	btgatt.uuid0x2bbf
Bluetooth GATT Attribute Termination Reason (UUID 0x2bc0)	btgatt.uuid0x2bc0
Bluetooth GATT Attribute Incoming Call (UUID 0x2bc1)	btgatt.uuid0x2bc1
Bluetooth GATT Attribute Call Friendly Name (UUID 0x2bc2)	btgatt.uuid0x2bc2
Bluetooth GATT Attribute Mute (UUID 0x2bc3)	btgatt.uuid0x2bc3
Bluetooth GATT Attribute Sink ASE (UUID 0x2bc4)	btgatt.uuid0x2bc4
Bluetooth GATT Attribute Source ASE (UUID 0x2bc5)	btgatt.uuid0x2bc5
Bluetooth GATT Attribute ASE Control Point (UUID 0x2bc6)	btgatt.uuid0x2bc6
Bluetooth GATT Attribute Broadcast Audio Scan Control Point (UUID 0x2bc7)	btgatt.uuid0x2bc7
Bluetooth GATT Attribute Broadcast Receive State (UUID 0x2bc8)	btgatt.uuid0x2bc8
Bluetooth GATT Attribute Sink PAC (UUID 0x2bc9)	btgatt.uuid0x2bc9
Bluetooth GATT Attribute Sink Audio Locations (UUID 0x2bca)	btgatt.uuid0x2bca
Bluetooth GATT Attribute Source PAC (UUID 0x2bcb)	btgatt.uuid0x2bcb
Bluetooth GATT Attribute Source Audio Locations (UUID 0x2bcc)	btgatt.uuid0x2bcc
Bluetooth GATT Attribute Available Audio Contexts (UUID 0x2bcd)	btgatt.uuid0x2bcd
Bluetooth GATT Attribute Supported Audio Contexts (UUID 0x2bce)	btgatt.uuid0x2bce
Bluetooth GATT Attribute Ammonia Concentration (UUID 0x2bcf)	btgatt.uuid0x2bcf
Bluetooth GATT Attribute Carbon Monoxide Concentration (UUID 0x2bd0)	btgatt.uuid0x2bd0
Bluetooth GATT Attribute Methane Concentration (UUID 0x2bd1)	btgatt.uuid0x2bd1
Bluetooth GATT Attribute Nitrogen Dioxide Concentration (UUID 0x2bd2)	btgatt.uuid0x2bd2
Bluetooth GATT Attribute Non-Methane Volatile Organic Compounds Concentration (UUID 0x2bd3)	btgatt.uuid0x2bd3
Bluetooth GATT Attribute Ozone Concentration (UUID 0x2bd4)	btgatt.uuid0x2bd4
Bluetooth GATT Attribute Particulate Matter - PM1 Concentration (UUID 0x2bd5)	btgatt.uuid0x2bd5
Bluetooth GATT Attribute Particulate Matter - PM2.5 Concentration (UUID 0x2bd6)	btgatt.uuid0x2bd6
Bluetooth GATT Attribute Particulate Matter - PM10 Concentration (UUID 0x2bd7)	btgatt.uuid0x2bd7
Bluetooth GATT Attribute Sulfur Dioxide Concentration (UUID 0x2bd8)	btgatt.uuid0x2bd8
Bluetooth GATT Attribute Sulfur Hexafluoride Concentration (UUID 0x2bd9)	btgatt.uuid0x2bd9
Bluetooth GATT Attribute Hearing Aid Features (UUID 0x2bda)	btgatt.uuid0x2bda
Bluetooth GATT Attribute Hearing Aid Preset Control Point (UUID 0x2bdb)	btgatt.uuid0x2bdb
Bluetooth GATT Attribute Active Preset Index (UUID 0x2bdc)	btgatt.uuid0x2bdc
Bluetooth GATT Attribute Stored Health Observations (UUID 0x2bdd)	btgatt.uuid0x2bdd
Bluetooth GATT Attribute Fixed String 64 (UUID 0x2bde)	btgatt.uuid0x2bde
Bluetooth GATT Attribute High Temperature (UUID 0x2bdf)	btgatt.uuid0x2bdf
Bluetooth GATT Attribute High Voltage (UUID 0x2be0)	btgatt.uuid0x2be0
Bluetooth GATT Attribute Light Distribution (UUID 0x2be1)	btgatt.uuid0x2be1
Bluetooth GATT Attribute Light Output (UUID 0x2be2)	btgatt.uuid0x2be2
Bluetooth GATT Attribute Light Source Type (UUID 0x2be3)	btgatt.uuid0x2be3
Bluetooth GATT Attribute Noise (UUID 0x2be4)	btgatt.uuid0x2be4
Bluetooth GATT Attribute Relative Runtime in a Correlated Color Temperature Range (UUID 0x2be5)	btgatt.uuid0x2be5
Bluetooth GATT Attribute Time Second 32 (UUID 0x2be6)	btgatt.uuid0x2be6
Bluetooth GATT Attribute VOC Concentration (UUID 0x2be7)	btgatt.uuid0x2be7
Bluetooth GATT Attribute Voltage Frequency (UUID 0x2be8)	btgatt.uuid0x2be8
Bluetooth GATT Attribute Battery Critical Status (UUID 0x2be9)	btgatt.uuid0x2be9
Bluetooth GATT Attribute Battery Health Status (UUID 0x2bea)	btgatt.uuid0x2bea
Bluetooth GATT Attribute Battery Health Information (UUID 0x2beb)	btgatt.uuid0x2beb
Bluetooth GATT Attribute Battery Information (UUID 0x2bec)	btgatt.uuid0x2bec
Bluetooth GATT Attribute Battery Level Status (UUID 0x2bed)	btgatt.uuid0x2bed
Bluetooth GATT Attribute Battery Time Status (UUID 0x2bee)	btgatt.uuid0x2bee
Bluetooth GATT Attribute Estimated Service Date (UUID 0x2bef)	btgatt.uuid0x2bef
Bluetooth GATT Attribute Battery Energy Status (UUID 0x2bf0)	btgatt.uuid0x2bf0
Bluetooth GATT Attribute Observation Schedule Changed (UUID 0x2bf1)	btgatt.uuid0x2bf1
Bluetooth GATT Attribute Current Elapsed Time (UUID 0x2bf2)	btgatt.uuid0x2bf2
Bluetooth GATT Attribute Health Sensor Features (UUID 0x2bf3)	btgatt.uuid0x2bf3
Bluetooth GATT Attribute GHS Control Point (UUID 0x2bf4)	btgatt.uuid0x2bf4
Bluetooth GATT Attribute LE GATT Security Levels (UUID 0x2bf5)	btgatt.uuid0x2bf5
Bluetooth GATT Attribute ESL Address (UUID 0x2bf6)	btgatt.uuid0x2bf6
Bluetooth GATT Attribute AP Sync Key Material (UUID 0x2bf7)	btgatt.uuid0x2bf7
Bluetooth GATT Attribute ESL Response Key Material (UUID 0x2bf8)	btgatt.uuid0x2bf8
Bluetooth GATT Attribute ESL Current Absolute Time (UUID 0x2bf9)	btgatt.uuid0x2bf9
Bluetooth GATT Attribute ESL Display Information (UUID 0x2bfa)	btgatt.uuid0x2bfa
Bluetooth GATT Attribute ESL Image Information (UUID 0x2bfb)	btgatt.uuid0x2bfb
Bluetooth GATT Attribute ESL Sensor Information (UUID 0x2bfc)	btgatt.uuid0x2bfc
Bluetooth GATT Attribute ESL LED Information (UUID 0x2bfd)	btgatt.uuid0x2bfd
Bluetooth GATT Attribute ESL Control Point (UUID 0x2bfe)	btgatt.uuid0x2bfe
Bluetooth GATT Attribute UDI for Medical Devices (UUID 0x2bff)	btgatt.uuid0x2bff
Bluetooth GATT Attribute GMAP Role (UUID 0x2c00)	btgatt.uuid0x2c00
Bluetooth GATT Attribute UGG Features (UUID 0x2c01)	btgatt.uuid0x2c01
Bluetooth GATT Attribute UGT Features (UUID 0x2c02)	btgatt.uuid0x2c02
Bluetooth GATT Attribute BGS Features (UUID 0x2c03)	btgatt.uuid0x2c03
Bluetooth GATT Attribute BGR Features (UUID 0x2c04)	btgatt.uuid0x2c04
CBOR Item Decoder	_ws.wscbor
Expert Info	_ws.expert
Lua Dissection	_ws.lua
